id,Tkl,TklW,Def 3rd,Mid 3rd,Att 3rd,Tkl.1,Att,Lost,Blocks,Sh,Pass,Int,Tkl+Int,Clr,Err
2f798b41,7,3,5,2,0,4,7,3,5,5,0,4,11,20,0
a4c3f7af,23,15,8,14,1,8,32,24,11,6,5,18,41,25,2
16714a62,38,24,26,12,0,15,32,17,42,26,16,65,103,221,1
26777636,0,0,0,0,0,0,0,0,0,0,0,0,0,0,0
3dd738a1,91,50,37,41,13,36,71,35,25,3,22,37,128,90,0
48b28bfd,70,34,32,37,1,17,55,38,29,7,22,75,145,58,1
c46fa34c,47,28,17,27,3,15,64,49,35,2,33,32,79,30,0
9b8970ce,9,5,5,3,1,2,4,2,5,3,2,7,16,8,0
b18a3023,58,31,36,22,0,28,50,22,26,16,10,56,114,153,1
c9e99e49,80,57,45,27,8,33,58,25,24,3,21,28,108,21,0
9260926b,43,29,24,19,0,14,27,13,30,13,17,41,84,70,3
ab914649,8,5,3,3,2,2,5,3,6,0,6,4,12,7,0
d7bf3d19,59,37,18,38,3,25,69,44,29,7,22,85,144,35,2
22721b88,52,35,32,12,8,23,56,33,28,11,17,45,97,86,1
bcc81786,59,43,45,10,4,22,31,9,25,7,18,45,104,127,1
ef9c1c95,93,54,36,50,7,43,113,70,56,4,52,57,150,96,1
872cd68c,48,30,40,6,2,16,39,23,23,5,18,37,85,75,1
a5db0bec,66,42,22,39,5,20,66,46,30,0,30,39,105,34,0
fa18c72e,41,31,23,17,1,10,47,37,24,0,24,16,57,11,1
2f965a72,0,0,0,0,0,0,1,1,0,0,0,0,0,7,4
9dd5da03,2,1,0,1,1,1,1,0,1,1,0,1,3,2,1
a557e6b0,12,9,5,6,1,5,15,10,7,4,3,46,58,21,0
eacb45fd,41,33,27,9,5,14,45,31,16,7,9,37,78,83,1
833a91a1,16,11,6,9,1,5,17,12,12,1,11,10,26,25,0
70d8e84c,43,30,33,10,0,28,40,12,18,11,7,16,59,97,0
eaf71a5e,84,57,41,37,6,27,68,41,30,11,19,26,110,61,3
d3ce9f1f,41,27,29,8,4,13,35,22,13,2,11,15,56,37,1
7844c810,0,0,0,0,0,0,0,0,0,0,0,0,0,0,0
776972d5,10,8,4,3,3,2,7,5,7,0,7,1,11,1,0
5046b7d4,16,11,3,8,5,4,22,18,18,1,17,9,25,1,0
509a4ccb,12,8,5,6,1,1,11,10,10,1,9,6,18,5,0
cee88597,34,22,22,6,6,12,28,16,23,9,14,27,61,64,1
f449640d,50,36,29,16,5,21,47,26,27,2,25,28,78,47,1
4e7bfc23,14,9,4,9,1,4,25,21,15,1,14,8,22,5,0
8ff07990,7,4,1,3,3,0,6,6,9,2,7,8,15,26,0
7fecbcdb,29,22,23,6,0,16,30,14,8,1,7,11,40,52,0
b2bd0f6c,30,21,18,11,1,12,61,49,30,4,26,19,49,17,0
a1d04509,18,11,6,10,2,4,14,10,16,4,12,6,24,9,0
5693aa98,0,0,0,0,0,0,0,0,0,0,0,1,1,0,0
67d251a2,9,7,5,3,1,4,9,5,6,3,3,8,17,14,0
e61bdd69,1,1,0,1,0,0,0,0,0,0,0,0,1,0,0
2515040a,4,2,3,1,0,1,5,4,4,3,1,7,11,38,1
7abfcbff,21,15,9,7,5,5,15,10,22,0,22,15,36,8,0
0d57f1c1,0,0,0,0,0,0,1,1,0,0,0,1,1,1,0
2174bc8d,48,33,23,21,4,21,49,28,20,6,14,28,76,45,0
61d618fa,11,8,5,3,3,2,11,9,3,0,3,2,13,3,0
b7e7937d,0,0,0,0,0,0,0,0,0,0,0,0,0,0,0
30395d3b,38,30,18,16,4,11,37,26,8,2,6,12,50,7,0
8a2248b4,0,0,0,0,0,0,2,2,0,0,0,0,0,5,3
378825c7,56,39,31,21,4,26,55,29,24,16,8,37,93,177,1
6fbde63a,62,41,21,31,10,17,62,45,31,4,27,28,90,14,0
b6e50615,39,27,21,11,7,12,25,13,15,2,13,24,63,53,0
9001138b,6,4,1,3,2,1,16,15,9,1,8,5,11,4,0
3250c6cd,4,3,1,1,2,2,6,4,1,0,1,0,4,1,0
5e6342d4,41,27,23,16,2,22,48,26,19,1,18,18,59,18,0
15285503,0,0,0,0,0,0,0,0,0,0,0,0,0,0,0
a51728e3,7,5,5,1,1,5,7,2,2,0,2,5,12,43,0
6c203af0,67,50,30,32,5,19,39,20,13,2,11,31,98,31,1
6191093d,23,14,10,12,1,7,36,29,15,3,12,19,42,9,1
d9afac11,5,3,0,3,2,2,9,7,7,2,5,1,6,11,0
c69ef855,57,37,23,30,4,22,69,47,27,6,21,31,88,31,0
8c2c48a9,3,1,0,3,0,1,6,5,0,0,0,2,5,3,0
f3642ba8,6,3,5,1,0,5,6,1,6,3,3,1,7,15,0
f6496133,2,2,0,2,0,0,3,3,2,0,2,0,2,1,0
e65dd8dc,0,0,0,0,0,0,0,0,0,0,0,0,0,2,0
e90af77c,4,1,1,2,1,1,4,3,1,0,1,0,4,0,0
96908f80,0,0,0,0,0,0,0,0,0,0,0,0,0,0,0
f3085377,8,5,6,0,2,6,8,2,4,1,3,4,12,5,0
a0791826,5,1,4,1,0,3,6,3,1,0,1,1,6,2,0
7cf9f0ed,17,11,5,9,3,10,23,13,5,0,5,6,23,11,0
20e73fac,55,30,18,30,7,20,93,73,48,4,44,45,100,29,0
fd771f95,6,4,0,4,2,1,6,5,6,2,4,0,6,3,0
3e016e5a,10,9,3,4,3,1,11,10,11,1,10,5,15,1,0
f83c8d6c,33,21,13,15,5,4,42,38,17,2,15,12,45,51,0
8746d5d0,18,12,13,5,0,7,20,13,6,0,6,13,31,23,0
26975a92,0,0,0,0,0,0,0,0,0,0,0,1,1,10,2
148e136f,7,4,2,2,3,2,4,2,0,0,0,1,8,0,0
148e136f,58,39,29,22,7,17,73,56,31,0,31,14,72,4,2
85322440,9,7,3,4,2,3,11,8,3,1,2,12,21,13,0
8d043f1d,16,9,7,6,3,5,13,8,6,1,5,10,26,1,0
677ee102,39,28,20,19,0,15,26,11,29,10,19,30,69,42,0
07296190,6,4,2,3,1,3,11,8,7,1,6,7,13,4,0
c58270f8,6,4,0,5,1,0,3,3,3,1,2,2,8,15,0
79b2399c,50,37,29,17,4,16,70,54,29,0,29,34,84,26,0
950ff24d,0,0,0,0,0,0,0,0,0,0,0,0,0,0,3
b4a014b1,70,42,51,15,4,28,38,10,50,29,21,29,99,155,3
8f898ba8,3,1,0,2,1,0,4,4,3,1,2,0,3,8,0
23b6ab66,1,0,0,1,0,1,3,2,0,0,0,2,3,3,0
527f063d,15,9,5,4,6,2,16,14,10,1,9,5,20,22,0
edd1466a,58,49,31,19,8,20,35,15,17,1,16,33,91,46,1
7961f7aa,37,22,10,18,9,11,35,24,32,1,31,24,61,30,0
346c15cc,1,0,1,0,0,0,2,2,1,0,1,2,3,0,0
873ce3a2,0,0,0,0,0,0,0,0,0,0,0,0,0,0,0
2235f850,3,2,1,1,1,2,5,3,0,0,0,2,5,1,0
a1017967,31,23,22,9,0,18,32,14,18,8,10,34,65,87,1
3010aefb,40,28,17,13,10,7,35,28,22,3,19,15,55,9,0
4e7d66f8,143,86,63,71,9,46,119,73,70,10,60,53,196,91,0
166a981d,15,12,9,5,1,9,19,10,5,2,3,15,30,18,0
535b0343,8,6,7,1,0,3,9,6,7,4,3,4,12,15,1
3f5b4635,62,46,36,24,2,31,59,28,29,16,13,56,118,124,2
15a21c79,3,0,1,2,0,1,1,0,2,1,1,1,4,9,0
7d45b97a,20,16,12,7,1,9,14,5,12,2,10,9,29,35,0
cfd8dde3,28,19,5,16,7,6,28,22,18,1,17,11,39,11,0
beb391dd,17,12,6,9,2,3,25,22,11,1,10,14,31,14,0
5d42d487,11,8,5,3,3,3,13,10,7,0,7,3,14,5,0
909222de,50,32,12,29,9,7,35,28,21,0,21,19,69,9,0
2434f24a,0,0,0,0,0,0,2,2,0,0,0,3,3,13,4
9980269a,6,6,3,1,2,2,4,2,0,0,0,0,6,6,0
85a44ecc,26,17,13,10,3,10,35,25,15,1,14,8,34,10,0
8f325097,21,11,12,8,1,7,16,9,5,2,3,13,34,12,0
06f33dc8,13,9,2,6,5,1,5,4,4,0,4,2,15,6,0
06f33dc8,4,2,2,1,1,1,5,4,1,0,1,2,6,2,0
3e092724,9,7,4,4,1,2,11,9,7,1,6,11,20,7,2
1ec7e1c5,52,35,40,12,0,20,33,13,45,25,20,36,88,184,2
3067cbef,20,11,14,4,2,6,10,4,14,6,8,10,30,46,0
c53083ad,25,16,12,10,3,7,29,22,12,1,11,11,36,22,0
fd2bc67d,43,28,32,10,1,21,36,15,44,25,19,47,90,130,2
a5876fca,12,7,3,4,5,8,13,5,11,2,9,3,15,34,0
75d97aa6,19,14,13,4,2,5,40,35,21,2,19,20,39,17,0
070a3904,9,3,1,5,3,1,7,6,0,0,0,3,12,3,0
44f8c299,62,45,21,37,4,20,67,47,41,6,35,32,94,19,0
92232aad,34,25,22,8,4,17,30,13,16,10,6,27,61,73,0
79685569,10,8,1,8,1,3,10,7,13,5,8,8,18,8,0
d33c706e,20,13,2,9,9,4,19,15,10,0,10,12,32,22,0
a6138e4a,12,9,4,6,2,4,14,10,5,0,5,10,22,13,0
ff16ecad,52,38,33,14,5,20,48,28,26,10,16,60,112,95,2
19cda00b,13,10,5,3,5,7,39,32,18,2,16,10,23,8,0
cd387ff4,33,20,21,12,0,7,22,15,33,18,15,46,79,116,3
65585e3a,23,15,6,12,5,6,16,10,13,0,13,13,36,5,0
d2110326,10,6,7,3,0,4,7,3,14,9,5,12,22,52,1
26383ea5,0,0,0,0,0,0,0,0,0,0,0,0,0,4,1
6605d143,0,0,0,0,0,0,0,0,0,0,0,0,0,0,0
6c6ecdd4,48,36,15,29,4,15,33,18,20,4,16,20,68,29,0
79584585,12,4,4,7,1,8,12,4,3,1,2,6,18,6,0
247accfd,71,51,45,22,4,24,50,26,52,26,26,58,129,148,0
a3d524cb,0,0,0,0,0,0,1,1,0,0,0,0,0,5,2
d2aa8ac0,54,33,20,33,1,20,43,23,21,7,14,19,73,29,0
92b56413,25,20,12,9,4,5,13,8,12,0,12,12,37,16,1
10650926,14,8,7,6,1,10,15,5,11,5,6,5,19,20,0
4be0b467,3,0,1,2,0,0,3,3,5,1,4,1,4,8,0
a712ca2b,58,43,35,22,1,21,48,27,38,25,13,76,134,128,0
7f622eef,32,21,14,14,4,13,34,21,29,2,27,11,43,16,2
933d3b51,55,39,32,20,3,19,29,10,34,15,19,45,100,126,0
43e7a164,65,43,52,11,2,25,52,27,34,5,29,57,122,155,2
083525e5,45,29,34,11,0,21,43,22,38,25,13,71,116,211,5
ccb1c3af,12,7,2,7,3,1,11,10,11,0,11,1,13,2,0
9ffdf29a,0,0,0,0,0,0,0,0,0,0,0,0,0,0,0
d28b4a9d,2,2,0,2,0,0,0,0,3,1,2,1,3,1,0
67ac5bb8,1,1,1,0,0,0,1,1,2,1,1,0,1,4,1
6421dd73,35,25,15,15,5,7,39,32,24,3,21,28,63,12,0
1a992676,20,14,4,13,3,6,32,26,18,2,16,28,48,8,0
ff0ab48c,50,39,33,15,2,20,47,27,47,13,34,50,100,99,2
0e12089d,0,0,0,0,0,0,0,0,0,0,0,0,0,2,0
f09a8b75,16,9,5,5,6,6,14,8,2,0,2,14,30,9,0
167d5018,19,11,12,7,0,8,16,8,21,11,10,39,58,119,2
51a3caf1,6,5,5,1,0,3,6,3,2,2,0,3,9,16,0
ae82fa48,0,0,0,0,0,0,0,0,4,0,4,1,1,0,0
7f3b388c,114,64,38,67,9,48,112,64,48,13,35,43,157,62,0
66116290,11,6,0,8,3,2,13,11,13,3,10,10,21,11,0
b82880c6,0,0,0,0,0,0,0,0,0,0,0,1,1,8,0
b396a0b1,5,2,2,1,2,4,8,4,1,0,1,4,9,3,0
bece776f,45,33,11,24,10,8,40,32,11,0,11,8,53,5,0
ac62861c,40,27,10,25,5,14,75,61,52,7,45,49,89,58,2
857e2586,0,0,0,0,0,0,1,1,2,0,2,0,0,0,0
375622c5,20,11,8,11,1,7,20,13,11,1,10,5,25,11,2
f51edbf3,6,3,3,3,0,3,5,2,0,0,0,0,6,4,0
9dafff2a,20,13,8,12,0,6,13,7,7,1,6,12,32,11,0
574aa9ec,4,2,3,1,0,1,3,2,0,0,0,3,7,6,0
45e17712,25,12,15,8,2,7,17,10,15,4,11,14,39,33,0
5aca2a18,0,0,0,0,0,0,0,0,0,0,0,0,0,0,0
4b96c347,21,11,9,8,4,8,27,19,21,2,19,20,41,7,0
9f6325f9,6,3,4,2,0,2,4,2,7,0,7,4,10,14,0
cf4053e2,16,11,9,7,0,6,27,21,18,1,17,10,26,15,0
23c63b7f,0,0,0,0,0,0,2,2,1,0,1,0,0,1,0
56b52c4e,6,5,3,2,1,4,6,2,4,1,3,4,10,3,0
4c700f46,37,18,22,14,1,20,53,33,22,12,10,37,74,92,3
1040e783,48,28,27,13,8,21,39,18,25,11,14,31,79,76,0
ea0ff634,16,11,5,7,4,3,18,15,11,0,11,6,22,19,0
9836e892,2,2,1,1,0,0,1,1,0,0,0,0,2,0,0
0049d544,7,4,1,3,3,1,4,3,1,0,1,4,11,4,0
ffa90327,23,18,7,13,3,9,29,20,11,1,10,7,30,7,1
dc3a9a0d,31,24,6,22,3,7,34,27,17,0,17,11,42,2,1
3f944dad,0,0,0,0,0,0,0,0,1,1,0,0,0,0,0
6ba71da5,26,16,20,6,0,10,16,6,30,22,8,31,57,128,2
81d9a76b,0,0,0,0,0,0,0,0,0,0,0,1,1,0,0
3befc2b6,57,38,15,37,5,21,52,31,32,7,25,15,72,45,1
c6056d58,36,23,22,12,2,15,29,14,28,18,10,54,90,279,2
1232e1dc,42,29,29,9,4,21,31,10,22,16,6,29,71,154,2
c27dfb82,50,31,14,32,4,15,50,35,27,0,27,25,75,27,0
743fd71f,0,0,0,0,0,0,3,3,2,0,2,0,0,0,0
8730ed6a,0,0,0,0,0,0,0,0,0,0,0,0,0,0,0
4d3e9033,0,0,0,0,0,0,0,0,0,0,0,0,0,0,1
7c6d6c96,42,29,32,8,2,22,31,9,58,47,11,49,91,191,6
e893fc23,2,1,0,2,0,1,3,2,2,1,1,0,2,3,0
aad56ca3,1,1,1,0,0,0,1,1,0,0,0,2,3,0,0
3acddfdd,7,5,1,3,3,0,2,2,5,0,5,2,9,2,0
c5a500ca,63,36,28,21,14,24,72,48,39,2,37,14,77,30,0
d2448564,69,43,39,18,12,21,73,52,31,3,28,23,92,19,1
8b298f56,23,14,3,13,7,12,42,30,16,1,15,14,37,15,1
8b298f56,1,1,1,0,0,0,0,0,0,0,0,0,1,0,0
53283127,23,17,15,6,2,9,24,15,11,3,8,19,42,31,1
e6bc67d7,0,0,0,0,0,0,0,0,0,0,0,0,0,0,0
5d8d7454,136,89,71,58,7,50,105,55,43,13,30,88,224,136,0
9453d2f4,4,1,0,2,2,0,5,5,4,1,3,2,6,1,0
bc270726,1,0,1,0,0,1,1,0,0,0,0,4,5,15,4
82671804,89,54,45,40,4,26,62,36,44,13,31,50,139,56,1
ec400194,44,29,33,9,2,14,47,33,29,12,17,43,87,79,1
9f29c204,64,44,37,22,5,23,49,26,25,5,20,59,123,91,1
0b4d8274,19,13,7,6,6,1,22,21,15,4,11,13,32,8,1
563fcd6b,2,2,2,0,0,2,4,2,1,0,1,2,4,1,0
3681cfff,39,26,27,12,0,16,30,14,38,27,11,56,95,241,1
6f5ead86,21,13,9,9,3,10,22,12,15,2,13,6,27,5,0
c4bbea9f,44,26,33,11,0,13,36,23,28,14,14,58,102,140,5
97b87472,1,0,1,0,0,0,4,4,0,0,0,0,1,1,0
d14229f3,27,15,11,8,8,11,42,31,22,1,21,9,36,8,1
7ffaf233,6,5,2,2,2,1,9,8,10,0,10,1,7,7,0
3767b3b7,74,42,55,18,1,31,69,38,57,26,31,84,158,135,3
20c2c0e8,28,18,12,11,5,7,25,18,16,3,13,11,39,15,2
8ff4872e,44,29,24,15,5,22,42,20,20,2,18,48,92,74,0
42eaa028,13,10,3,6,4,4,14,10,8,0,8,6,19,3,0
f352a2db,13,9,1,9,3,3,16,13,8,0,8,12,25,16,0
b86fe156,29,19,10,15,4,7,29,22,17,2,15,20,49,13,3
3e87d087,0,0,0,0,0,0,0,0,0,0,0,1,1,1,0
46d50339,29,21,21,8,0,11,26,15,18,6,12,16,45,47,0
1bc6135b,1,1,1,0,0,0,5,5,1,0,1,3,4,1,0
689c9cf4,43,30,25,14,4,14,24,10,21,1,20,14,57,50,0
22a62523,4,1,1,1,2,1,2,1,1,0,1,1,5,0,0
7d9b37bf,12,8,4,7,1,5,21,16,14,1,13,14,26,10,0
2e52206e,12,7,5,6,1,1,13,12,9,3,6,6,18,26,0
7cab69b5,48,32,32,15,1,24,31,7,46,32,14,56,104,169,1
a56bd2ee,0,0,0,0,0,0,1,1,0,0,0,0,0,14,4
13c44fc5,69,40,34,25,10,23,38,15,19,2,17,66,135,86,0
5d66c10d,3,2,0,2,1,1,6,5,5,1,4,3,6,2,0
0eb03d5b,18,14,11,7,0,6,14,8,18,10,8,27,45,67,0
f36c432f,4,4,0,3,1,0,9,9,5,0,5,3,7,3,0
f323d995,36,25,27,9,0,15,32,17,29,19,10,40,76,182,5
8ba3a754,8,5,7,1,0,5,10,5,5,2,3,6,14,7,0
5b1bf5e3,54,32,14,27,13,9,40,31,33,3,30,26,80,19,0
81d3318f,32,24,11,14,7,10,35,25,18,2,16,15,47,8,0
3814120d,0,0,0,0,0,0,2,2,0,0,0,1,1,6,3
cc77354e,14,14,9,5,0,8,12,4,7,3,4,3,17,18,0
b4c816a9,2,2,0,2,0,0,2,2,0,0,0,0,2,1,0
a4527d33,1,1,1,0,0,1,3,2,0,0,0,3,4,9,2
4657faba,1,0,1,0,0,0,4,4,0,0,0,0,1,4,0
0515a4cb,62,45,47,14,1,35,65,30,49,40,9,62,124,249,2
06f46837,14,9,4,5,5,5,15,10,9,0,9,5,19,8,0
abccacf7,1,0,0,0,1,0,0,0,0,0,0,0,1,2,0
796b1c41,57,25,22,27,8,15,50,35,12,2,10,27,84,9,0
2677a1de,26,18,7,10,9,7,39,32,29,0,29,7,33,7,0
aef6e670,39,28,20,18,1,9,14,5,17,10,7,24,63,80,1
faf873a7,0,0,0,0,0,0,0,0,0,0,0,1,1,1,1
d3b58e33,1,1,1,0,0,1,1,0,0,0,0,0,1,2,0
fcbcbd94,8,6,1,4,3,3,23,20,10,2,8,3,11,11,0
1f713024,26,17,23,3,0,12,31,19,20,10,10,33,59,122,2
1f9a3a04,6,4,4,2,0,0,2,2,5,3,2,5,11,14,0
ce316f8c,24,13,14,8,2,5,19,14,16,1,15,8,32,6,1
86a2ba20,5,2,2,2,1,2,3,1,1,0,1,5,10,0,0
dc366c36,0,0,0,0,0,0,1,1,0,0,0,3,3,22,3
4d1666ff,26,19,19,7,0,13,17,4,14,11,3,14,40,97,0
9a493fb7,16,8,9,5,2,5,16,11,8,3,5,19,35,7,1
9a506145,18,12,7,11,0,3,17,14,11,2,9,16,34,39,0
41e7ef1c,44,32,20,15,9,15,39,24,16,3,13,35,79,41,2
4bf69118,8,6,6,2,0,7,11,4,2,0,2,1,9,7,0
f45cf4f7,0,0,0,0,0,0,0,0,0,0,0,0,0,0,0
7cdda3bf,9,7,1,6,2,2,7,5,8,2,6,1,10,7,1
5984e9f9,13,8,8,5,0,5,9,4,6,3,3,11,24,54,1
4e7db402,1,0,1,0,0,1,4,3,0,0,0,2,3,20,5
770d7eb8,87,47,53,28,6,21,47,26,18,10,8,42,129,70,2
8614496d,3,1,3,0,0,3,5,2,2,1,1,3,6,12,0
542cc80f,68,45,27,39,2,12,54,42,20,1,19,57,125,26,0
6e5b5a45,17,13,11,6,0,6,12,6,10,4,6,19,36,24,1
d512db65,0,0,0,0,0,0,3,3,0,0,0,1,1,0,0
321a71a7,48,36,28,18,2,20,41,21,36,13,23,65,113,105,4
7cf431a5,31,21,9,19,3,6,41,35,21,1,20,18,49,14,1
2fa2a875,1,1,1,0,0,0,0,0,1,0,1,0,1,14,1
f5044e54,78,47,29,39,10,27,76,49,52,11,41,34,112,38,2
4dbd0916,33,17,9,19,5,10,41,31,22,1,21,18,51,16,1
47c2e669,5,3,3,1,1,2,6,4,1,0,1,0,5,6,0
1b82f8df,107,74,33,61,13,33,107,74,44,8,36,67,174,66,1
96fcd380,0,0,0,0,0,0,0,0,0,0,0,0,0,1,2
6b9f2f3e,9,7,5,3,1,3,6,3,2,2,0,7,16,11,0
f7691f63,77,51,37,32,8,30,84,54,35,2,33,52,129,41,1
0f52f925,73,46,40,27,6,31,68,37,42,6,36,38,111,85,0
d7553721,77,58,26,36,15,26,74,48,30,5,25,19,96,12,1
6bca20fe,9,5,4,5,0,4,7,3,0,0,0,2,11,0,0
f00de885,0,0,0,0,0,0,0,0,0,0,0,1,1,17,4
7c2965bb,55,32,15,27,13,21,78,57,23,2,21,16,71,22,0
20094685,30,20,12,12,6,12,56,44,16,2,14,7,37,6,1
54131505,12,9,4,6,2,3,7,4,5,0,5,1,13,1,0
88fdac8b,8,4,8,0,0,4,4,0,6,4,2,8,16,22,1
c121a641,0,0,0,0,0,0,1,1,0,0,0,0,0,0,0
d4133fa1,26,16,11,12,3,7,24,17,13,1,12,31,57,56,0
31377e38,7,3,5,1,1,4,5,1,1,0,1,2,9,2,0
f329ec76,1,1,1,0,0,1,3,2,0,0,0,3,4,0,0
91e58f66,55,40,26,26,3,15,61,46,32,10,22,61,116,47,1
e768de1f,29,18,16,10,3,12,30,18,8,4,4,19,48,10,0
fcb38f57,1,1,1,0,0,1,1,0,0,0,0,0,1,8,6
22bfb57e,4,2,2,2,0,1,2,1,1,0,1,3,7,1,1
6853490f,15,10,3,7,5,1,28,27,13,1,12,14,29,6,0
d6a889ea,51,37,31,16,4,17,25,8,13,5,8,38,89,47,0
c26a3918,84,49,56,22,6,42,76,34,34,2,32,34,118,103,0
1d2d5cc8,0,0,0,0,0,0,0,0,0,0,0,0,0,10,3
de343d38,25,14,8,16,1,8,18,10,9,3,6,18,43,21,1
dbb10755,37,24,29,8,0,11,21,10,28,18,10,24,61,120,4
c801616a,92,59,35,46,11,28,120,92,40,5,35,40,132,45,1
392d98fc,32,23,16,9,7,8,25,17,22,3,19,18,50,15,0
706a60e1,5,5,3,2,0,0,2,2,1,0,1,0,5,0,0
e54a9890,6,3,2,3,1,2,10,8,12,2,10,6,12,5,0
9ae9eaea,34,20,22,8,4,14,29,15,14,6,8,26,60,69,0
51fa3fed,1,1,0,1,0,0,1,1,1,0,1,0,1,0,0
e3d0b0c4,27,25,16,10,1,9,25,16,32,18,14,57,84,235,4
5c4dc0ff,16,11,0,5,11,2,23,21,9,1,8,3,19,20,0
0d2158d5,63,38,22,36,5,18,66,48,26,9,17,40,103,25,2
cdf65d12,36,26,22,13,1,15,22,7,19,15,4,15,51,72,2
d5f2f82b,28,14,14,14,0,13,21,8,36,22,14,14,42,114,2
468fdbad,73,50,41,28,4,17,54,37,30,3,27,33,106,36,0
1ad8cb67,41,34,28,12,1,22,49,27,25,12,13,51,92,112,3
0e96a5e1,3,2,0,3,0,1,2,1,0,0,0,1,4,0,0
b51242ef,34,18,21,10,3,8,23,15,9,3,6,37,71,39,1
639b42f5,2,1,2,0,0,2,2,0,3,0,3,5,7,2,0
c0cddebe,1,1,1,0,0,0,0,0,2,1,1,0,1,0,0
42fd9c7f,11,8,3,3,5,1,13,12,4,1,3,0,11,1,0
42fd9c7f,1,1,0,1,0,0,0,0,0,0,0,1,2,0,0
b931d9d1,71,48,48,18,5,41,65,24,21,1,20,28,99,50,0
aa1a8c7e,16,11,4,8,4,6,16,10,8,1,7,4,20,5,0
6afaebf2,0,0,0,0,0,0,3,3,2,0,2,0,0,2,0
4887118d,0,0,0,0,0,0,0,0,2,0,2,0,0,2,0
5cec2c74,25,13,4,19,2,9,32,23,22,6,16,23,48,13,1
5cec2c74,2,1,1,1,0,2,5,3,1,0,1,3,5,3,0
8f696594,13,9,4,3,6,3,28,25,15,0,15,9,22,5,0
6690ef25,62,50,37,19,6,23,41,18,36,25,11,44,106,152,0
c6e5d20f,25,16,10,11,4,5,23,18,21,3,18,25,50,29,0
e68f2cb4,18,10,7,7,4,2,11,9,11,1,10,15,33,8,0
e067808c,4,4,1,2,1,1,6,5,5,1,4,1,5,4,0
3cefcaef,45,28,29,13,3,20,31,11,18,5,13,25,70,43,0
1598599e,13,6,8,5,0,5,17,12,9,1,8,13,26,10,1
f99fe221,18,10,12,6,0,11,20,9,5,0,5,17,35,26,0
e162b013,38,21,22,12,4,18,34,16,7,2,5,18,56,54,2
ce492295,15,12,9,6,0,9,12,3,13,7,6,16,31,98,2
e39f8724,0,0,0,0,0,0,1,1,0,0,0,0,0,0,1
cb9ec45d,11,7,7,4,0,7,11,4,3,1,2,4,15,12,0
1251f42e,8,4,0,4,4,1,9,8,5,0,5,3,11,2,0
c6ac6579,3,2,1,2,0,1,4,3,1,1,0,0,3,2,0
7e82a78f,25,18,10,12,3,3,25,22,8,1,7,11,36,8,0
84d94b91,81,49,33,43,5,34,87,53,52,17,35,55,136,81,2
4a57580c,33,25,9,19,5,11,48,37,15,2,13,13,46,23,1
e97150c0,39,27,23,15,1,18,23,5,28,23,5,46,85,129,5
3eaf8817,8,5,4,0,4,0,7,7,6,2,4,2,10,11,0
57ef0d97,28,21,14,11,3,8,24,16,15,6,9,21,49,26,1
6ca88b2a,28,15,20,7,1,10,34,24,23,7,16,27,55,75,0
28a65a2c,0,0,0,0,0,0,0,0,0,0,0,0,0,3,2
2b622f01,1,1,0,1,0,0,1,1,0,0,0,0,1,0,0
f5a00fa4,65,41,19,37,9,27,80,53,52,12,40,36,101,54,0
af0c835b,15,7,6,7,2,5,8,3,7,1,6,3,18,4,0
176674ab,8,4,6,2,0,4,10,6,11,0,11,9,17,4,0
176674ab,14,8,5,6,3,5,13,8,9,0,9,3,17,3,0
ac73ec79,70,55,41,25,4,25,44,19,26,14,12,73,143,104,2
e50623a0,16,10,6,9,1,6,24,18,6,2,4,16,32,29,0
4749367a,9,5,6,3,0,5,10,5,6,1,5,2,11,5,0
77f278a0,10,6,2,5,3,2,9,7,5,0,5,3,13,0,0
61590953,0,0,0,0,0,0,1,1,0,0,0,0,0,1,0
8e87af42,10,8,3,6,1,2,7,5,2,0,2,5,15,0,0
fa00f0c9,0,0,0,0,0,0,0,0,0,0,0,0,0,0,0
5cdddffa,6,5,2,4,0,1,4,3,4,0,4,5,11,3,0
5cdddffa,62,39,23,31,8,11,40,29,53,8,45,36,98,9,0
69384e5d,20,14,3,11,6,7,40,33,4,0,4,5,25,2,0
813aae2f,11,10,4,6,1,3,10,7,10,0,10,9,20,6,0
45076ff8,10,5,5,5,0,1,8,7,9,1,8,2,12,2,0
34cfec6b,8,5,4,4,0,4,20,16,5,3,2,9,17,19,0
75a63397,27,22,11,12,4,5,21,16,10,0,10,18,45,13,0
00242715,57,38,44,12,1,22,37,15,27,14,13,55,112,139,1
1ac3b888,22,12,5,10,7,6,26,20,11,2,9,9,31,13,0
46faabfa,6,5,4,1,1,2,8,6,6,0,6,4,10,8,0
91f2da4c,12,7,1,6,5,2,10,8,12,2,10,4,16,13,0
1ec4e202,31,14,12,14,5,11,51,40,18,1,17,16,47,20,0
bf354e77,9,6,4,5,0,1,4,3,7,1,6,1,10,0,0
7c56da38,5,2,2,2,1,3,14,11,8,2,6,5,10,2,1
268c3cfc,0,0,0,0,0,0,0,0,0,0,0,0,0,2,0
81aeb1dd,14,8,8,5,1,8,17,9,4,1,3,3,17,4,0
6043997c,4,2,4,0,0,0,3,3,2,2,0,3,7,18,2
c3512013,13,9,9,2,2,6,13,7,9,1,8,7,20,15,0
a08b974a,83,57,30,44,9,30,93,63,42,3,39,30,113,26,0
9e27e5de,16,11,5,9,2,8,31,23,20,4,16,11,27,8,0
243f4a0b,64,42,25,37,2,20,61,41,26,4,22,32,96,35,0
ae7d0ecd,0,0,0,0,0,0,1,1,0,0,0,3,3,9,1
e3e05edf,2,1,1,1,0,0,1,1,2,1,1,6,8,6,0
29d8ad3f,16,15,13,3,0,10,16,6,13,7,6,16,32,96,1
f86ca403,24,16,9,13,2,3,17,14,21,9,12,24,48,34,0
779847d6,39,28,25,9,5,18,36,18,34,19,15,35,74,182,3
25444898,29,15,17,9,3,17,29,12,16,2,14,22,51,31,0
881ef58c,33,21,9,16,8,5,23,18,13,0,13,10,43,14,1
450e277f,13,7,10,3,0,7,20,13,14,11,3,21,34,120,0
58ae47b2,22,11,5,13,4,8,37,29,19,2,17,19,41,7,1
2f8f43f3,22,11,6,14,2,6,31,25,17,3,14,7,29,11,0
88615858,20,9,9,8,3,4,28,24,11,0,11,15,35,13,0
76806215,0,0,0,0,0,0,1,1,0,0,0,1,1,2,0
a44d3a3c,0,0,0,0,0,0,2,2,1,0,1,0,0,0,0
97fb4608,32,20,13,15,4,10,28,18,15,6,9,32,64,31,0
57e3f0c7,30,18,14,11,5,11,42,31,23,0,23,10,40,20,0
6dfd8f05,0,0,0,0,0,0,0,0,0,0,0,0,0,0,0
6b200d45,39,26,28,10,1,21,31,10,35,22,13,36,75,142,1
8e2d5426,22,12,10,10,2,5,26,21,13,5,8,30,52,18,0
b6dac747,28,17,14,12,2,11,43,32,9,2,7,19,47,13,0
64ba07c0,43,31,33,7,3,17,28,11,11,2,9,9,52,35,0
fca455cc,25,16,9,12,4,6,35,29,10,1,9,18,43,14,0
516dc25b,24,14,7,17,0,7,31,24,18,6,12,21,45,15,0
bc6bd723,15,9,5,7,3,5,32,27,14,3,11,8,23,21,0
7add56e1,0,0,0,0,0,0,1,1,5,3,2,1,1,2,0
31bbb7e2,58,37,23,29,6,25,66,41,19,0,19,24,82,22,1
1e23a224,6,0,4,2,0,3,5,2,2,2,0,1,7,12,0
ccbbe661,9,8,3,5,1,0,7,7,2,1,1,3,12,11,0
fa27b5a0,3,2,1,2,0,2,2,0,1,0,1,1,4,4,1
b92edde2,53,29,32,16,5,28,51,23,14,6,8,35,88,63,1
51c30111,37,18,9,24,4,8,39,31,19,5,14,30,67,25,0
b0547a87,34,27,10,15,9,9,33,24,25,4,21,21,55,12,0
b0547a87,3,3,0,1,2,1,5,4,3,0,3,0,3,2,0
1061c207,0,0,0,0,0,0,0,0,0,0,0,0,0,2,2
4df04a86,0,0,0,0,0,0,0,0,0,0,0,0,0,0,0
bcb98316,9,5,2,5,2,3,4,1,7,3,4,4,13,2,0
8794e251,59,36,27,23,9,15,36,21,29,10,19,33,92,22,1
9a1f2e1c,54,28,30,18,6,22,43,21,20,3,17,42,96,53,0
bd4f5f94,20,10,15,4,1,10,27,17,12,6,6,31,51,66,0
8dbff17c,39,29,22,15,2,22,41,19,25,19,6,45,84,163,3
276cce2e,29,22,18,8,3,12,28,16,20,6,14,19,48,76,0
d504b3e1,13,8,7,5,1,6,17,11,7,2,5,1,14,9,0
e0d725fe,14,11,5,5,4,4,18,14,10,0,10,7,21,3,0
bcf1b2e9,6,4,5,1,0,5,7,2,2,0,2,2,8,35,1
7a137df4,0,0,0,0,0,0,0,0,0,0,0,0,0,0,0
2bae5658,10,3,1,6,3,1,12,11,8,0,8,2,12,5,0
7af0e1f8,81,59,50,26,5,41,80,39,21,7,14,39,120,73,0
1f8c7aa9,33,22,7,18,8,8,42,34,21,2,19,28,61,41,1
0eeafda5,44,29,28,15,1,23,40,17,22,14,8,37,81,126,0
ed45c4a5,73,49,25,39,9,17,64,47,42,6,36,40,113,13,1
9b6d9b53,73,54,47,23,3,26,68,42,43,9,34,58,131,124,0
13203c45,40,27,17,19,4,15,26,11,26,3,23,15,55,52,0
3071a619,24,17,8,10,6,7,38,31,32,2,30,25,49,22,0
cac76a72,0,0,0,0,0,0,0,0,0,0,0,0,0,14,1
a87e9eb6,4,1,3,1,0,3,3,0,1,0,1,1,5,0,0
17f29fb0,6,5,2,3,1,2,11,9,3,2,1,5,11,1,0
fbbb9269,93,61,54,34,5,43,68,25,26,6,20,54,147,104,0
68a87d66,1,1,0,1,0,0,1,1,1,0,1,2,3,1,0
68a87d66,10,8,6,0,4,2,10,8,2,0,2,5,15,6,0
22c77851,0,0,0,0,0,0,1,1,1,0,1,0,0,0,0
90fcf472,33,22,17,11,5,7,26,19,15,1,14,15,48,4,0
2b16cb1a,18,14,13,2,3,12,28,16,12,1,11,11,29,10,0
2b16cb1a,0,0,0,0,0,0,0,0,0,0,0,0,0,0,0
d63e2912,66,45,30,30,6,32,49,17,32,7,25,45,111,90,1
57c433c8,5,4,1,2,2,0,7,7,4,0,4,2,7,11,0
5d59e0df,19,11,3,9,7,5,33,28,27,3,24,9,28,50,0
bb4a42be,11,9,4,6,1,4,15,11,7,1,6,7,18,2,0
c3725db2,15,13,10,5,0,5,12,7,11,6,5,26,41,62,1
cfe852d8,0,0,0,0,0,0,2,2,0,0,0,0,0,12,3
60d90c55,0,0,0,0,0,0,0,0,0,0,0,0,0,2,0
24eb7ed6,21,12,6,11,4,6,28,22,16,0,16,20,41,18,0
8802c1d5,29,25,17,9,3,10,36,26,14,0,14,5,34,15,0
bced0375,72,47,35,34,3,29,69,40,33,7,26,24,96,19,1
c650629d,33,23,10,20,3,4,34,30,15,4,11,21,54,7,0
a8b4a643,27,19,8,18,1,8,28,20,20,8,12,25,52,64,1
11ced928,11,6,1,5,5,3,11,8,6,1,5,6,17,14,1
6e7f1353,64,40,13,34,17,21,71,50,30,0,30,25,89,5,1
5e22e2a4,59,40,25,29,5,23,83,60,39,8,31,43,102,48,2
086d7db3,19,12,5,8,6,4,29,25,13,5,8,4,23,33,0
a2da58b1,0,0,0,0,0,0,0,0,0,0,0,0,0,0,0
1a4b9094,65,42,42,20,3,22,38,16,20,4,16,32,97,53,2
bfdb33aa,20,10,5,10,5,7,29,22,17,0,17,9,29,3,1
4315f30d,24,18,17,7,0,8,18,10,14,6,8,31,55,44,2
e1b3413d,60,47,41,14,5,40,61,21,25,8,17,51,111,98,1
6aeb647a,20,14,10,9,1,11,14,3,10,8,2,17,37,58,1
4db2157a,73,45,29,42,2,18,61,43,37,15,22,34,107,53,1
10efd0e1,25,14,9,12,4,9,56,47,16,4,12,26,51,15,4
7fb301af,2,2,1,0,1,1,2,1,2,0,2,4,6,14,0
c4527123,5,3,3,2,0,2,6,4,8,7,1,6,11,23,0
35c5f9b1,4,4,2,2,0,1,7,6,0,0,0,0,4,2,0
4c5b714f,59,39,24,27,8,23,45,22,20,4,16,46,105,52,1
adf825b9,0,0,0,0,0,0,0,0,0,0,0,1,1,0,0
4914ed4a,28,20,19,4,5,19,31,12,21,6,15,37,65,83,1
86e7deaf,31,23,19,12,0,12,21,9,28,18,10,18,49,114,0
0fe7f7bc,14,8,2,9,3,0,20,20,11,0,11,6,20,23,1
c2211709,89,54,34,47,8,37,88,51,59,10,49,77,166,57,4
2e0367a6,47,32,20,17,10,20,52,32,22,2,20,13,60,7,0
ad625c12,0,0,0,0,0,0,3,3,1,0,1,2,2,2,1
c1febb46,65,45,21,36,8,14,54,40,34,2,32,34,99,35,0
7768df30,32,19,24,7,1,10,32,22,37,24,13,53,85,152,4
e3ad3368,0,0,0,0,0,0,0,0,1,0,1,0,0,0,0
7b075c75,9,5,7,2,0,2,3,1,22,16,6,16,25,50,1
ae59b359,13,9,8,5,0,3,14,11,8,1,7,7,20,6,1
4e0afc5d,89,68,58,26,5,36,56,20,46,16,30,39,128,72,2
84549a07,17,11,6,9,2,4,14,10,12,0,12,7,24,6,1
6fb7edd3,4,3,1,1,2,1,16,15,7,0,7,3,7,1,0
7b536033,0,0,0,0,0,0,0,0,0,0,0,0,0,0,0
f6db3bd5,0,0,0,0,0,0,2,2,1,0,1,0,0,13,2
821233cc,23,14,16,7,0,10,27,17,13,9,4,18,41,96,1
beff5d14,4,4,1,3,0,0,4,4,7,0,7,3,7,3,0
8417953b,0,0,0,0,0,0,0,0,0,0,0,0,0,2,0
b99bec05,44,32,22,16,6,19,47,28,31,4,27,34,78,65,1
d8b97bb3,0,0,0,0,0,0,2,2,2,0,2,0,0,1,0
e61d33f1,1,1,1,0,0,0,2,2,1,0,1,2,3,2,0
15e1afd5,23,17,17,5,1,10,26,16,5,3,2,26,49,48,0
942c6dc3,1,1,0,1,0,0,1,1,0,0,0,0,1,0,0
ec1aa15e,7,6,4,3,0,2,5,3,3,1,2,9,16,15,1
a0f9b535,50,36,26,18,6,18,78,60,43,4,39,20,70,17,1
8da74c05,58,36,32,21,5,26,47,21,26,5,21,41,99,22,1
730bd100,12,6,4,5,3,2,5,3,2,0,2,3,15,2,0
b056e3da,1,0,1,0,0,1,2,1,0,0,0,1,2,12,3
d520120b,3,1,1,1,1,1,11,10,11,6,5,3,6,36,0
4f093689,4,4,1,3,0,0,1,1,0,0,0,1,5,0,0
5148dcc5,42,30,16,23,3,9,28,19,11,1,10,14,56,6,0
77d7c96f,37,25,24,10,3,15,26,11,20,7,13,29,66,52,0
2b9fdeea,44,28,16,20,8,15,46,31,22,1,21,17,61,20,0
6b994195,36,27,23,13,0,11,24,13,19,15,4,31,67,113,1
7de29631,0,0,0,0,0,0,0,0,0,0,0,0,0,0,0
275e2c51,31,21,16,15,0,14,29,15,32,19,13,34,65,151,1
c76b7567,71,52,41,23,7,22,73,51,58,4,54,18,89,20,0
6f8cd6d0,20,15,6,10,4,6,25,19,14,0,14,5,25,12,0
56f7a928,47,24,14,28,5,17,55,38,24,5,19,34,81,20,1
871fc5f8,1,0,0,1,0,0,1,1,1,0,1,1,2,0,0
de4fe7a2,4,4,1,0,3,0,7,7,2,0,2,2,6,12,0
5ceba7fc,17,8,2,5,10,5,29,24,13,0,13,15,32,2,0
7adea561,43,25,35,7,1,17,39,22,25,16,9,28,71,121,0
ef7cd87a,74,52,28,38,8,23,67,44,40,10,30,62,136,49,1
c8c60119,51,29,31,13,7,18,30,12,15,2,13,22,73,61,0
d72db2f5,0,0,0,0,0,0,0,0,0,0,0,1,1,0,0
d72db2f5,2,1,0,1,1,0,7,7,5,0,5,1,3,0,0
71ec39ef,98,59,41,55,2,38,98,60,41,16,25,52,150,79,0
1a6f2a66,6,4,0,4,2,1,4,3,3,0,3,3,9,1,0
c47541e0,32,20,7,20,5,10,35,25,24,3,21,39,71,31,1
de488e56,60,32,46,9,5,26,56,30,52,16,36,57,117,171,0
a4b1028a,79,55,43,31,5,41,66,25,31,12,19,61,140,117,0
b666421b,54,32,40,13,1,14,29,15,25,10,15,52,106,132,2
883f251e,9,9,2,3,4,3,7,4,6,3,3,2,11,21,0
ce17b5eb,0,0,0,0,0,0,0,0,0,0,0,0,0,1,0
cc41f558,14,8,13,1,0,5,14,9,10,2,8,5,19,17,0
dcf7cf44,22,11,7,14,1,8,32,24,8,1,7,6,28,5,1
8cb8dc58,13,7,6,7,0,9,12,3,14,11,3,16,29,72,0
1d0900d4,2,2,2,0,0,2,2,0,0,0,0,2,4,14,2
7cb9de24,0,0,0,0,0,0,0,0,0,0,0,0,0,3,0
1467af0d,51,33,20,25,6,12,55,43,25,6,19,26,77,11,3
446aa6e1,21,15,17,3,1,14,37,23,18,16,2,20,41,129,2
eb78322b,2,1,2,0,0,0,0,0,0,0,0,1,3,8,0
0984c5d5,11,7,4,6,1,3,7,4,2,1,1,5,16,3,0
0984c5d5,23,10,9,13,1,2,23,21,7,3,4,11,34,14,0
8eec784d,1,1,1,0,0,1,1,0,0,0,0,0,1,0,0
f3600c02,25,14,10,11,4,10,38,28,13,2,11,16,41,21,0
f3600c02,1,0,1,0,0,0,0,0,1,0,1,1,2,0,0
7f9111ea,49,36,28,17,4,20,37,17,16,7,9,34,83,64,1
1c344204,58,42,46,12,0,16,34,18,24,16,8,54,112,138,5
20573d10,3,2,3,0,0,1,1,0,0,0,0,1,4,2,0
e2f9bb5f,3,1,2,1,0,1,2,1,1,0,1,1,4,1,0
6bb2c084,88,65,23,57,8,32,94,62,50,7,43,67,155,46,3
c8c02ac7,17,12,10,5,2,9,25,16,10,2,8,12,29,44,0
e750cba4,1,1,1,0,0,1,2,1,0,0,0,2,3,10,1
775185ae,0,0,0,0,0,0,0,0,0,0,0,0,0,0,0
a8797cf1,54,37,21,26,7,24,56,32,30,5,25,38,92,41,2
