id,Tkl,TklW,Def 3rd,Mid 3rd,Att 3rd,Tkl.1,Att,Lost,Blocks,Sh,Pass,Int,Tkl+Int,Clr,Err
0033fb1b,28,14,9,12,7,11,24,13,20,1,19,23,51,16,0
005c0807,36,21,18,9,9,18,39,21,22,0,22,32,68,38,0
0118c54c,80,46,47,27,6,35,69,34,30,4,26,55,135,65,1
032f894e,13,7,4,8,1,5,25,20,13,2,11,13,26,8,0
037f2523,5,3,1,4,0,2,4,2,5,0,5,1,6,3,0
0557ff4f,6,3,5,1,0,4,6,2,2,1,1,2,8,11,2
0630eb63,6,5,1,2,3,2,12,10,8,0,8,3,9,1,0
065dc209,13,8,0,8,5,4,19,15,5,2,3,4,17,8,0
06c48679,60,39,26,28,6,22,38,16,37,19,18,56,116,81,1
06df8256,24,17,15,9,0,13,28,15,21,12,9,58,82,102,4
08082af0,14,7,9,5,0,13,28,15,22,19,3,31,45,52,0
08534272,2,2,0,1,1,0,5,5,1,0,1,0,2,3,0
09507ffa,1,1,0,1,0,0,0,0,2,1,1,0,1,2,0
095e4199,20,10,11,1,8,8,22,14,12,1,11,3,23,8,0
0a8d6b91,5,4,1,4,0,4,5,1,0,0,0,3,8,0,0
0ad37003,58,31,24,33,1,25,60,35,34,5,29,31,89,13,1
0b0cbe5b,52,28,22,24,6,16,58,42,32,3,29,20,72,36,0
0b4d8274,12,7,5,6,1,4,24,20,17,1,16,7,19,11,0
0bb6e193,30,20,20,8,2,7,19,12,6,2,4,9,39,13,0
0be95d34,30,11,5,14,11,5,25,20,6,0,6,3,33,4,1
0c2ac3cb,54,26,18,28,8,28,49,21,18,3,15,13,67,6,0
0cbc8baa,38,21,24,14,0,15,32,17,24,16,8,30,68,70,0
0d2158d5,34,17,9,23,2,23,56,33,14,5,9,23,57,12,2
0d3585b5,4,2,0,3,1,0,3,3,2,0,2,1,5,2,0
0d7b6576,4,3,2,1,1,1,6,5,4,0,4,2,6,5,0
0d99c6e1,0,0,0,0,0,0,0,0,0,0,0,0,0,0,0
0e46fa2f,0,0,0,0,0,0,0,0,0,0,0,0,0,0,0
0e7ccfc4,55,30,29,17,9,33,60,27,28,10,18,38,93,40,1
0f26fd24,4,1,2,0,2,1,1,0,0,0,0,0,4,0,0
0f8418aa,68,48,25,35,8,28,68,40,22,5,17,48,116,44,0
0f86995c,4,3,2,2,0,2,9,7,2,0,2,3,7,6,0
0f9b8301,5,2,1,4,0,2,9,7,0,0,0,4,9,5,0
1001ae82,9,4,1,7,1,4,8,4,3,0,3,5,14,5,0
10efd0e1,17,9,3,12,2,4,15,11,8,2,6,12,29,7,0
10f0fdd3,56,39,22,25,9,14,23,9,20,2,18,19,75,16,0
114bbdee,57,34,47,10,0,30,55,25,43,17,26,74,131,135,2
11ff3d56,14,9,2,9,3,4,8,4,4,0,4,3,17,3,0
12bd0579,12,6,6,3,3,7,12,5,2,1,1,12,24,16,1
132a82f1,6,4,6,0,0,3,4,1,3,3,0,8,14,14,1
1467af0d,53,30,17,25,11,24,72,48,22,5,17,26,79,4,1
14b8fcdf,0,0,0,0,0,0,1,1,1,1,0,1,1,1,0
1545cf15,28,19,19,5,4,16,28,12,14,2,12,14,42,35,0
15944afd,11,5,6,5,0,3,7,4,1,0,1,1,12,2,0
16324e1d,12,7,9,3,0,9,19,10,19,12,7,33,45,57,2
165a2e40,13,6,3,7,3,4,30,26,7,0,7,5,18,22,0
166a981d,0,0,0,0,0,0,0,0,0,0,0,0,0,0,0
16aa7d4c,51,29,31,19,1,27,41,14,54,41,13,64,115,151,0
1787195f,18,8,7,5,6,8,20,12,9,0,9,6,24,5,0
17f29fb0,0,0,0,0,0,0,2,2,0,0,0,0,0,0,0
18ebca4b,24,15,6,11,7,12,32,20,15,1,14,9,33,19,0
19053e31,49,34,17,25,7,18,53,35,25,1,24,31,80,15,0
19a12bed,65,39,40,16,9,27,49,22,39,12,27,55,120,61,1
19ba6c6d,15,11,3,11,1,3,28,25,18,3,15,12,27,40,0
19cda00b,26,17,6,8,12,11,45,34,14,1,13,6,32,7,0
1a4b9094,1,1,0,0,1,1,1,0,1,1,0,1,2,1,0
1a992676,13,6,5,6,2,5,20,15,4,0,4,14,27,0,0
1ad8cb67,10,7,7,3,0,7,7,0,6,4,2,11,21,28,0
1b6862e8,15,7,7,3,5,5,14,9,7,1,6,7,22,3,0
1bfe34dc,11,8,7,4,0,4,9,5,2,0,2,4,15,11,0
1d2d5cc8,0,0,0,0,0,0,1,1,0,0,0,2,2,8,6
1ddbc7ca,12,8,7,4,1,6,11,5,10,2,8,6,18,14,0
1df4a109,3,1,0,3,0,2,3,1,1,0,1,0,3,0,0
1ec7e1c5,22,13,13,8,1,12,18,6,17,13,4,44,66,99,1
1f6298f2,0,0,0,0,0,0,0,0,0,0,0,0,0,0,0
20094685,1,1,1,0,0,0,2,2,0,0,0,2,3,2,0
2054d037,3,2,2,1,0,0,0,0,2,0,2,1,4,2,0
20de219a,0,0,0,0,0,0,0,0,0,0,0,0,0,1,0
20e73fac,40,23,17,16,7,21,71,50,37,1,36,19,59,25,0
2145368f,66,36,30,25,11,30,65,35,48,19,29,59,125,39,2
22721b88,11,9,9,1,1,9,12,3,12,2,10,27,38,33,1
2306bfde,0,0,0,0,0,0,0,0,0,0,0,1,1,0,0
2321ea6e,42,29,16,24,2,18,49,31,27,5,22,44,86,44,0
23bf644d,0,0,0,0,0,0,4,4,0,0,0,5,5,1,0
23c63b7f,4,3,0,2,2,3,12,9,7,1,6,6,10,3,0
2434f24a,1,1,1,0,0,1,3,2,1,0,1,1,2,17,0
243f4a0b,54,31,33,19,2,26,55,29,20,5,15,26,80,36,0
244bc2c8,23,12,3,11,9,4,22,18,19,5,14,12,35,37,1
24eb7ed6,41,29,20,14,7,26,38,12,27,14,13,39,80,46,0
2500cef9,35,20,12,14,9,11,34,23,25,3,22,20,55,14,0
25146df0,0,0,0,0,0,0,0,0,0,0,0,0,0,0,0
2515040a,35,18,21,13,1,16,21,5,33,24,9,52,87,123,1
2591b066,25,15,16,6,3,13,32,19,17,2,15,9,34,18,0
26777636,74,37,30,33,11,35,92,57,27,2,25,39,113,17,2
2677a1de,24,15,12,7,5,12,24,12,10,1,9,4,28,11,0
2693f6bc,1,0,0,0,1,0,0,0,0,0,0,0,1,0,0
2736b85e,6,3,3,3,0,3,7,4,3,0,3,2,8,0,0
275e2c51,47,25,34,11,2,20,35,15,35,20,15,50,97,138,0
279ddf6a,92,50,47,38,7,26,74,48,43,9,34,43,135,29,1
288e1e13,37,30,28,9,0,21,33,12,34,22,12,47,84,102,0
28a65a2c,2,1,2,0,0,2,3,1,0,0,0,2,4,9,2
28dabd43,1,1,1,0,0,1,2,1,0,0,0,2,3,23,1
28f66c2e,21,15,16,5,0,10,16,6,3,0,3,6,27,12,0
2945f4b7,7,4,1,1,5,2,12,10,2,0,2,2,9,4,0
295ba708,22,14,10,11,1,9,21,12,12,3,9,12,34,7,0
29939a1d,0,0,0,0,0,0,7,7,6,1,5,4,4,1,0
29aee77c,0,0,0,0,0,0,0,0,0,0,0,1,1,0,0
29c02c9f,23,11,4,17,2,14,19,5,18,5,13,16,39,18,1
29d8ad3f,17,11,13,4,0,8,14,6,17,12,5,25,42,46,1
29ef0f49,6,4,2,3,1,0,4,4,4,2,2,0,6,6,0
2a657da0,40,17,15,19,6,13,43,30,11,0,11,17,57,12,0
2ab14aaa,5,3,5,0,0,3,6,3,3,2,1,6,11,11,0
2acf0cd7,35,19,19,14,2,21,41,20,33,25,8,57,92,85,3
2aeb43f1,2,1,2,0,0,1,1,0,1,0,1,0,2,1,0
2b1bed19,69,39,32,28,9,31,66,35,26,5,21,57,126,34,0
2b5a35e5,2,2,1,1,0,0,1,1,2,0,2,1,3,0,0
2b9b37b2,0,0,0,0,0,0,0,0,0,0,0,0,0,0,1
2b9fdeea,40,22,14,21,5,20,54,34,26,2,24,14,54,11,0
2c127b6f,0,0,0,0,0,0,0,0,0,0,0,0,0,1,0
2d22cea7,30,10,10,19,1,7,26,19,21,0,21,15,45,4,0
2d70dbe5,0,0,0,0,0,0,1,1,1,0,1,0,0,15,2
2d9f280e,2,0,0,0,2,1,3,2,0,0,0,1,3,1,0
2fa2a875,0,0,0,0,0,0,2,2,1,0,1,2,2,20,1
3010aefb,36,21,17,15,4,16,36,20,16,3,13,20,56,17,0
30144daa,18,5,7,10,1,8,23,15,12,0,12,14,32,6,0
3043d33f,20,12,8,8,4,7,38,31,20,2,18,8,28,10,0
3071a619,7,3,1,4,2,3,8,5,6,0,6,5,12,4,0
309937e7,0,0,0,0,0,0,2,2,0,0,0,2,2,7,0
30af8b93,50,34,25,20,5,31,51,20,20,3,17,16,66,37,0
31626657,145,84,64,69,12,54,162,108,64,6,58,46,191,12,0
31a62dc7,72,33,30,30,12,44,81,37,32,6,26,38,110,52,0
3225654e,3,1,2,1,0,2,2,0,1,1,0,3,6,1,0
329e7a13,0,0,0,0,0,0,0,0,0,0,0,0,0,0,0
32c2d95f,59,37,36,23,0,26,42,16,34,15,19,61,120,132,0
32f3d97e,18,3,7,8,3,11,18,7,10,0,10,7,25,4,1
33508c78,20,12,6,9,5,9,22,13,11,1,10,13,33,3,0
33887998,0,0,0,0,0,0,0,0,0,0,0,0,0,0,0
3423f250,5,2,1,3,1,1,4,3,5,0,5,3,8,4,0
34e4343c,2,1,0,2,0,1,4,3,3,1,2,0,2,3,0
3544641e,5,3,1,3,1,2,10,8,0,0,0,1,6,1,0
3681cfff,19,13,12,6,1,10,12,2,13,9,4,31,50,41,2
3708e9fa,28,16,6,18,4,8,39,31,21,0,21,11,39,3,0
375622c5,58,40,34,22,2,31,103,72,30,5,25,8,66,18,1
380a15e2,0,0,0,0,0,0,0,0,0,0,0,1,1,2,0
3814120d,1,1,1,0,0,1,3,2,0,0,0,1,2,2,1
39c0c75b,0,0,0,0,0,0,0,0,1,1,0,1,1,0,0
3befc2b6,65,41,50,15,0,39,70,31,34,15,19,59,124,103,0
3c6bbbab,104,68,64,30,10,43,73,30,62,17,45,112,216,119,1
3cd7820a,32,22,18,11,3,15,28,13,10,0,10,24,56,18,0
3d50bcdb,11,8,2,6,3,3,12,9,7,1,6,8,19,10,0
3dd738a1,63,37,32,21,10,32,52,20,30,3,27,47,110,43,1
3ef0fa48,41,26,12,16,13,15,37,22,20,0,20,13,54,8,0
3ef68782,13,6,1,8,4,2,9,7,7,1,6,2,15,7,0
3f5b4635,59,35,45,12,2,36,70,34,50,33,17,69,128,144,3
4047c976,3,1,0,2,1,1,7,6,1,0,1,0,3,2,0
40774c6b,5,3,3,2,0,2,4,2,2,0,2,0,5,0,0
414e1f69,3,3,1,0,2,0,1,1,2,0,2,0,3,1,0
41e7ef1c,26,19,10,10,6,9,28,19,20,5,15,28,54,26,1
42dcf26d,26,17,20,6,0,19,31,12,30,18,12,33,59,119,1
42eaa028,18,12,3,8,7,9,22,13,16,1,15,7,25,9,0
42fd9c7f,4,2,0,1,3,2,9,7,7,1,6,3,7,4,1
433dc9a2,5,3,0,4,1,3,5,2,4,0,4,1,6,6,0
436a9dd0,53,35,17,26,10,30,77,47,31,5,26,31,84,22,1
43b78598,6,2,1,2,3,4,13,9,3,1,2,3,9,7,0
43e7a164,60,41,45,13,2,32,52,20,28,10,18,91,151,104,0
44f8c299,47,32,20,22,5,16,49,33,20,3,17,20,67,30,4
450e277f,11,6,8,3,0,8,23,15,13,11,2,21,32,40,0
45bb4303,1,0,1,0,0,0,2,2,0,0,0,0,1,0,0
45c1c326,22,12,10,9,3,6,18,12,10,0,10,11,33,8,0
462475ed,30,18,6,18,6,7,31,24,14,5,9,11,41,54,0
46359159,26,13,8,14,4,11,36,25,8,0,8,12,38,6,0
46750e9c,33,19,9,13,11,8,28,20,17,0,17,14,47,10,0
468fdbad,11,9,5,4,2,5,14,9,11,2,9,13,24,2,1
46907171,1,1,1,0,0,1,6,5,0,0,0,2,3,2,0
469d3d84,8,2,5,0,3,3,12,9,6,2,4,4,12,5,0
46a7b605,12,10,6,4,2,4,10,6,5,0,5,1,13,0,0
46faabfa,1,1,0,0,1,1,2,1,3,0,3,0,1,8,0
475583ff,21,12,12,7,2,12,29,17,10,3,7,16,37,28,0
47af88b8,25,16,16,9,0,6,13,7,36,25,11,27,52,91,1
47c609d5,22,12,3,16,3,8,18,10,8,3,5,6,28,10,1
48b28bfd,47,25,18,26,3,20,51,31,17,5,12,54,101,33,0
49070d66,7,4,4,3,0,5,12,7,5,4,1,8,15,16,0
49136c42,26,17,17,9,0,13,28,15,44,31,13,59,85,118,4
4914ed4a,7,6,7,0,0,1,2,1,4,1,3,6,13,8,0
4a537185,0,0,0,0,0,0,1,1,0,0,0,0,0,0,0
4a57580c,11,7,7,2,2,5,10,5,5,0,5,6,17,7,0
4a987ffa,6,4,2,2,2,1,7,6,6,0,6,5,11,7,0
4b6960d2,23,16,12,8,3,9,18,9,14,3,11,29,52,43,0
4b96c347,22,13,4,12,6,12,34,22,17,0,17,15,37,9,0
4bd00a50,5,3,5,0,0,3,7,4,1,1,0,3,8,12,0
4be0b467,15,10,3,9,3,4,18,14,6,3,3,5,20,16,0
4bf69118,21,12,15,4,2,14,27,13,15,3,12,26,47,27,0
4c4ffacc,25,11,17,8,0,7,31,24,14,2,12,18,43,36,0
4c5b714f,58,34,26,29,3,37,52,15,20,5,15,50,108,37,2
4e0afc5d,50,33,35,13,2,27,48,21,15,6,9,17,67,34,0
4e7db402,1,0,1,0,0,1,1,0,1,0,1,0,1,14,0
4e9957ff,0,0,0,0,0,0,0,0,2,1,1,1,1,3,0
4eb0686f,6,1,2,2,2,2,9,7,9,0,9,1,7,2,0
4ef705ab,6,3,1,4,1,3,3,0,2,0,2,1,7,2,0
4f255115,127,68,47,62,18,48,92,44,39,11,28,60,187,47,0
5046b7d4,9,6,1,7,1,4,12,8,9,0,9,9,18,9,0
514270e8,2,0,1,1,0,1,5,4,1,0,1,6,8,1,0
5148dcc5,33,15,5,15,13,10,36,26,23,0,23,16,49,7,0
5167c97e,48,32,21,21,6,23,37,14,29,6,23,35,83,60,0
51b41c5c,51,31,21,24,6,20,54,34,21,11,10,53,104,46,0
51c30111,3,2,0,3,0,2,5,3,4,3,1,4,7,2,1
51dbeea9,31,26,17,11,3,10,26,16,16,4,12,15,46,37,1
5219ab4a,43,20,12,20,11,17,38,21,24,1,23,45,88,46,0
5313ed43,16,8,3,10,3,4,26,22,16,5,11,34,50,23,1
5314e067,53,33,30,16,7,29,45,16,17,2,15,21,74,38,0
539b4f25,4,2,3,1,0,4,6,2,5,4,1,6,10,30,1
53f6306f,23,15,7,10,6,5,18,13,15,2,13,9,32,5,0
542cc80f,46,26,25,19,2,17,40,23,25,5,20,47,93,17,2
54d51e22,74,45,39,33,2,36,89,53,25,1,24,27,101,35,0
5515376c,45,26,32,13,0,24,50,26,20,7,13,69,114,56,0
562a4799,60,35,45,15,0,32,58,26,44,27,17,60,120,132,1
5722eced,24,11,2,15,7,10,33,23,13,1,12,3,27,4,0
574aa9ec,33,20,20,10,3,16,22,6,25,10,15,27,60,52,0
57a46f3f,11,4,2,6,3,4,5,1,5,1,4,1,12,0,1
58ad9383,2,1,2,0,0,2,5,3,1,0,1,2,4,17,3
58ae47b2,27,17,4,16,7,17,40,23,19,2,17,8,35,10,0
59948ef7,4,4,1,2,1,2,3,1,2,0,2,0,4,4,0
5b146df3,19,10,12,4,3,7,11,4,13,6,7,23,42,38,1
5b1bf5e3,38,23,10,18,10,8,44,36,24,3,21,17,55,4,0
5b5724d2,37,25,18,14,5,16,29,13,3,1,2,38,75,28,0
5b92d896,1,1,0,0,1,0,1,1,0,0,0,0,1,0,0
5c61496e,2,1,2,0,0,0,1,1,1,0,1,0,2,0,0
5c9ac7f0,0,0,0,0,0,0,1,1,2,0,2,0,0,1,0
5ceba7fc,16,10,5,3,8,8,32,24,20,1,19,26,42,8,0
5d0e0a1f,38,18,18,12,8,13,24,11,26,5,21,18,56,38,1
5d5219b1,10,8,3,5,2,4,12,8,7,3,4,2,12,2,0
5d8d7454,37,19,23,11,3,21,34,13,14,1,13,33,70,32,0
5d93ccee,12,7,8,4,0,8,14,6,7,2,5,10,22,17,1
5e080f73,10,5,3,6,1,4,22,18,17,3,14,9,19,23,2
5e22e2a4,9,6,3,5,1,2,7,5,4,0,4,7,16,8,0
5ea9ebd4,26,20,10,14,2,11,39,28,6,0,6,2,28,8,0
5ee6e943,0,0,0,0,0,0,0,0,0,0,0,0,0,2,0
5f0241b2,0,0,0,0,0,0,0,0,0,0,0,0,0,1,0
5f26e0c5,46,27,37,8,1,28,38,10,24,10,14,42,88,78,1
5f3eaaf5,27,14,11,9,7,17,36,19,24,1,23,15,42,15,1
5fdcb075,11,6,8,3,0,6,15,9,8,1,7,6,17,16,0
602fc7b5,0,0,0,0,0,0,2,2,2,0,2,0,0,0,0
6043997c,12,10,2,8,2,4,6,2,8,5,3,10,22,32,1
60f58477,4,3,1,3,0,3,4,1,2,0,2,0,4,0,0
61590953,27,19,15,9,3,13,22,9,17,4,13,26,53,38,2
6191093d,58,30,18,37,3,23,54,31,33,4,29,21,79,19,0
62e02107,11,7,8,2,1,3,9,6,7,2,5,21,32,12,0
6481421d,10,6,4,4,2,4,22,18,5,1,4,10,20,4,0
64ba07c0,60,40,42,16,2,35,52,17,17,7,10,30,90,57,0
64c14d49,1,1,0,1,0,0,0,0,0,0,0,2,3,1,0
64f69877,33,16,11,19,3,8,34,26,23,0,23,4,37,4,0
6554bb97,1,0,0,1,0,1,3,2,3,1,2,2,3,3,0
6605d143,12,7,3,7,2,8,19,11,12,2,10,13,25,17,0
667b65da,0,0,0,0,0,0,0,0,0,0,0,0,0,3,0
6690ef25,21,19,16,5,0,14,21,7,23,13,10,34,55,58,0
677ee102,26,12,12,10,4,9,27,18,18,5,13,33,59,72,0
67b7357e,33,21,23,10,0,12,24,12,18,12,6,30,63,89,0
68a26d51,26,8,7,13,6,14,49,35,23,4,19,41,67,19,0
69384e5d,14,11,1,6,7,8,37,29,8,0,8,9,23,0,0
6a827d8e,25,12,11,14,0,13,26,13,10,2,8,26,51,12,0
6b2c894b,57,32,35,17,5,32,56,24,25,11,14,30,87,67,0
6b4436ba,0,0,0,0,0,0,0,0,0,0,0,1,1,0,0
6bde367b,49,33,16,25,8,22,73,51,28,6,22,38,87,15,0
6be41a31,6,3,3,1,2,3,8,5,1,0,1,1,7,3,1
6c8ddd52,57,43,32,24,1,30,59,29,25,5,20,43,100,64,0
6d075c67,0,0,0,0,0,0,1,1,0,0,0,0,0,1,0
6de23ab0,10,7,8,1,1,5,14,9,19,15,4,33,43,53,1
6dfd8f05,60,34,42,16,2,24,45,21,36,3,33,45,105,76,0
6e2c94ad,0,0,0,0,0,0,2,2,0,0,0,0,0,0,0
6e5b5a45,36,20,20,13,3,11,37,26,17,8,9,29,65,33,1
6e7f1353,21,12,6,12,3,9,28,19,12,0,12,9,30,5,0
6f5ec8bb,39,22,22,15,2,24,38,14,25,9,16,39,78,51,3
6f806d99,51,28,23,23,5,27,73,46,30,6,24,25,76,10,0
6fbde63a,10,5,5,3,2,2,10,8,3,0,3,6,16,2,0
706a60e1,13,8,4,4,5,4,11,7,6,1,5,6,19,4,0
70c52749,49,31,27,15,7,33,50,17,43,9,34,36,85,70,0
7155e3e1,49,21,25,19,5,15,45,30,25,6,19,47,96,34,0
72a0fb65,52,38,46,6,0,29,40,11,50,33,17,57,109,165,3
72c812f3,63,35,20,34,9,26,50,24,26,7,19,20,83,9,3
741418c3,40,19,17,14,9,14,48,34,16,2,14,14,54,3,0
743fd71f,16,9,5,5,6,2,15,13,6,0,6,4,20,1,1
745ca0a3,54,27,26,23,5,21,54,33,30,0,30,30,84,18,0
74733221,0,0,0,0,0,0,1,1,0,0,0,1,1,6,3
74dc806c,11,7,1,7,3,2,9,7,3,0,3,2,13,0,0
754d5c33,0,0,0,0,0,0,0,0,1,0,1,0,0,0,0
75a63397,15,8,2,8,5,3,10,7,14,2,12,1,16,1,0
7615f332,3,0,3,0,0,3,5,2,1,0,1,0,3,0,0
767212e6,16,11,6,8,2,11,25,14,12,4,8,9,25,10,0
76806215,0,0,0,0,0,0,0,0,0,0,0,0,0,0,0
770d7eb8,22,13,13,8,1,11,22,11,12,6,6,23,45,33,1
775185ae,9,5,3,4,2,2,6,4,6,0,6,6,15,3,0
779847d6,58,36,42,14,2,38,72,34,44,20,24,37,95,155,1
77d7c96f,2,0,1,1,0,0,0,0,0,0,0,2,4,0,0
7909ffa4,12,8,5,6,1,6,31,25,12,3,9,11,23,15,0
792a9d41,6,4,4,2,0,3,6,3,2,0,2,1,7,0,0
79685569,8,5,5,1,2,7,13,6,12,5,7,17,25,19,1
796b1c41,19,11,7,6,6,7,16,9,8,0,8,12,31,1,0
79b2399c,53,28,24,17,12,31,79,48,25,1,24,47,100,32,0
7a0b1e96,1,0,1,0,0,0,0,0,0,0,0,1,2,1,0
7a42d0df,31,20,3,20,8,6,22,16,27,0,27,9,40,24,0
7b075c75,1,0,0,0,1,0,0,0,1,1,0,2,3,2,0
7b9a9e25,14,8,5,5,4,6,21,15,13,2,11,9,23,10,0
7b9c2d84,98,58,39,48,11,38,77,39,36,2,34,23,121,15,1
7c2965bb,20,14,4,13,3,6,27,21,14,3,11,8,28,6,0
7c3ed041,29,18,19,7,3,14,31,17,17,9,8,28,57,65,3
7cbf91b2,4,2,0,2,2,2,2,0,0,0,0,2,6,1,0
7cdda3bf,43,22,21,17,5,16,60,44,29,3,26,16,59,25,1
7cf431a5,5,2,1,3,1,2,2,0,3,0,3,1,6,1,1
7d08063d,35,22,12,16,7,17,49,32,16,3,13,21,56,31,0
7d937aa1,23,14,10,8,5,9,15,6,4,1,3,2,25,1,0
7d9397f8,32,16,5,21,6,9,27,18,21,9,12,18,50,22,1
7d9b37bf,4,3,1,1,2,0,5,5,4,0,4,2,6,2,0
7d9f3d69,0,0,0,0,0,0,0,0,0,0,0,0,0,0,0
7e82a78f,20,15,7,11,2,12,47,35,18,4,14,32,52,9,1
7ef972c3,23,15,15,5,3,10,21,11,17,6,11,14,37,32,0
7f622eef,0,0,0,0,0,0,0,0,0,0,0,0,0,0,0
7fecbcdb,27,17,19,7,1,19,28,9,7,1,6,19,46,34,0
80556f08,33,22,15,16,2,16,58,42,21,5,16,32,65,42,1
8104e41e,4,3,1,1,2,1,3,2,5,1,4,4,8,1,0
822d51d7,90,51,31,51,8,42,82,40,43,7,36,34,124,14,2
82518f62,76,34,26,41,9,30,64,34,24,4,20,14,90,13,0
8332db56,32,18,19,11,2,20,35,15,22,5,17,24,56,30,1
833ce5f0,0,0,0,0,0,0,0,0,0,0,0,0,0,0,0
834b5c4c,0,0,0,0,0,0,0,0,0,0,0,0,0,4,0
8413ceb1,6,4,5,1,0,4,8,4,2,1,1,2,8,8,0
84c0768a,10,7,6,3,1,6,12,6,5,3,2,14,24,15,1
84d94b91,28,15,9,16,3,15,41,26,10,3,7,13,41,21,1
85613cf0,14,9,0,7,7,2,12,10,5,1,4,2,16,9,0
8577e60a,99,67,43,46,10,33,60,27,50,12,38,78,177,51,0
85847c67,0,0,0,0,0,0,0,0,0,0,0,0,0,1,0
85a44ecc,78,41,33,34,11,39,75,36,29,4,25,33,111,17,0
861227d2,58,34,43,13,2,31,54,23,36,20,16,80,138,146,1
873ce3a2,24,14,15,6,3,13,33,20,14,2,12,6,30,6,0
8746d5d0,25,11,14,10,1,13,26,13,10,3,7,24,49,41,1
87e9c7cd,15,8,9,2,4,7,20,13,9,0,9,4,19,6,0
8802c1d5,15,10,9,5,1,9,26,17,6,0,6,9,24,3,0
881cd6be,7,2,4,2,1,6,10,4,1,0,1,6,13,2,1
8846a40f,29,17,12,15,2,10,40,30,21,4,17,15,44,16,0
885b7aa7,53,32,22,30,1,25,70,45,35,7,28,37,90,40,0
88970207,1,0,1,0,0,0,8,8,2,0,2,2,3,2,0
88c4d190,15,10,9,4,2,7,21,14,14,1,13,8,23,11,0
88f130ed,25,15,16,9,0,16,31,15,13,7,6,19,44,48,1
8a2248b4,1,1,1,0,0,1,3,2,1,0,1,1,2,7,2
8b298f56,20,8,9,8,3,7,31,24,7,0,7,5,25,3,0
8bbe2df5,28,18,11,13,4,12,27,15,14,4,10,26,54,21,0
8bc373ea,15,13,10,5,0,6,10,4,7,4,3,27,42,87,0
8db95f95,0,0,0,0,0,0,0,0,0,0,0,0,0,0,0
8e697a8f,7,6,3,4,0,1,8,7,4,0,4,7,14,4,0
8eec784d,15,7,3,9,3,7,14,7,7,0,7,4,19,5,0
8f325097,39,30,27,11,1,20,40,20,20,11,9,26,65,62,0
8f4d116f,16,10,10,4,2,10,30,20,15,8,7,25,41,21,2
8f696594,4,3,0,3,1,1,20,19,11,1,10,5,9,3,0
8fd9996f,21,11,6,11,4,6,14,8,14,6,8,29,50,33,4
90a9cc01,1,1,0,1,0,0,4,4,1,0,1,3,4,2,0
90c99c5c,1,1,1,0,0,0,0,0,0,0,0,0,1,1,0
90eb507d,77,43,50,20,7,40,69,29,28,7,21,69,146,92,2
90f87966,40,29,28,10,2,27,33,6,36,23,13,36,76,137,1
91f2da4c,0,0,0,0,0,0,0,0,0,0,0,0,0,1,0
92232aad,58,33,37,17,4,40,62,22,27,9,18,45,103,61,0
923f4dda,4,1,1,3,0,1,3,2,10,1,9,5,9,17,0
9260926b,39,26,18,19,2,15,38,23,14,4,10,23,62,25,0
92b56413,0,0,0,0,0,0,1,1,0,0,0,0,0,0,0
93b8f9f4,7,4,4,3,0,3,9,6,6,1,5,2,9,3,0
942b4f90,18,9,2,10,6,3,13,10,16,0,16,13,31,3,0
94f8d10c,29,17,19,9,1,17,30,13,29,22,7,44,73,130,0
95192fe4,0,0,0,0,0,0,2,2,1,0,1,0,0,0,0
95981861,0,0,0,0,0,0,1,1,1,0,1,2,2,0,0
95bb6ddc,38,25,14,19,5,15,45,30,17,1,16,14,52,9,0
96726741,1,1,1,0,0,1,1,0,1,1,0,0,1,1,0
96e5168e,19,12,7,8,4,11,17,6,8,1,7,3,22,4,0
972aeb2a,15,9,8,5,2,5,6,1,17,16,1,26,41,80,2
9744ff80,15,11,6,6,3,10,38,28,9,1,8,5,20,8,0
97bfa797,2,0,0,2,0,2,2,0,0,0,0,0,2,0,0
9826ea33,1,1,1,0,0,1,1,0,0,0,0,0,1,0,0
9836e892,12,8,5,7,0,5,13,8,9,0,9,3,15,5,0
9980269a,3,1,0,1,2,2,8,6,3,1,2,2,5,12,0
999ceb5f,3,2,1,2,0,1,1,0,1,0,1,0,3,0,0
9ae9eaea,1,0,0,1,0,0,0,0,0,0,0,2,3,0,0
9b398aea,3,2,1,2,0,3,5,2,2,1,1,4,7,1,0
9b40a6ea,80,47,30,44,6,33,74,41,37,10,27,50,130,29,3
9b5237b1,0,0,0,0,0,0,0,0,0,0,0,0,0,0,0
9b6556d2,15,9,4,7,4,6,22,16,3,0,3,8,23,1,0
9b6f7fd5,70,36,30,28,12,23,66,43,28,3,25,20,90,16,1
9ba7b4fa,5,3,5,0,0,3,4,1,1,1,0,2,7,13,0
9c221d14,35,22,26,9,0,20,39,19,40,31,9,68,103,144,1
9c2b1f11,7,2,1,2,4,2,9,7,2,1,1,2,9,5,0
9d5dcc23,18,9,4,11,3,7,24,17,7,2,5,21,39,5,0
9daeac61,48,33,25,19,4,22,36,14,18,4,14,42,90,50,0
9ddf7fae,0,0,0,0,0,0,0,0,0,0,0,0,0,0,0
9f90c06b,5,2,5,0,0,2,2,0,3,2,1,5,10,14,0
a046fc35,3,1,1,1,1,2,2,0,0,0,0,0,3,0,0
a0791826,24,16,4,17,3,13,51,38,19,3,16,12,36,7,0
a0b65401,10,6,4,6,0,2,5,3,1,1,0,7,17,4,0
a0f9b535,26,11,11,12,3,10,32,22,17,3,14,13,39,2,0
a13028f6,1,1,1,0,0,1,2,1,0,0,0,0,1,0,0
a1f3f5a0,12,5,6,2,4,7,14,7,5,0,5,10,22,3,0
a27ecdc2,1,1,1,0,0,1,3,2,0,0,0,0,1,0,0
a2d873dd,14,6,5,8,1,6,25,19,17,2,15,8,22,14,0
a44d3a3c,2,1,0,2,0,0,0,0,1,0,1,0,2,0,0
a4527d33,1,0,1,0,0,1,1,0,0,0,0,0,1,4,2
a46472d0,9,6,5,4,0,5,8,3,4,3,1,15,24,36,0
a4b1028a,56,38,23,27,6,22,59,37,31,5,26,76,132,50,0
a4c3f7af,34,19,16,14,4,15,30,15,9,2,7,20,54,10,0
a59d55b1,2,0,1,1,0,1,1,0,1,0,1,1,3,2,0
a5db0bec,17,12,0,13,4,8,25,17,17,1,16,17,34,4,0
a634b9d2,7,0,3,3,1,4,9,5,3,1,2,6,13,8,0
a7e4760c,0,0,0,0,0,0,0,0,0,0,0,1,1,1,0
a84f9a4b,38,23,22,10,6,17,31,14,16,2,14,22,60,34,0
a8567629,38,30,15,14,9,17,26,9,22,2,20,22,60,20,0
a99138af,22,15,12,10,0,9,33,24,10,1,9,10,32,11,1
a99da9ec,15,8,3,9,3,1,6,5,12,1,11,10,25,6,0
aa21406e,1,0,1,0,0,0,2,2,0,0,0,0,1,1,0
aa67d758,0,0,0,0,0,0,0,0,0,0,0,0,0,0,0
aad56ca3,31,18,7,16,8,10,41,31,22,6,16,17,48,23,0
ab096c6f,28,15,23,5,0,19,27,8,24,15,9,36,64,80,1
abc06eb3,0,0,0,0,0,0,2,2,0,0,0,2,2,12,4
ad82197c,29,20,17,12,0,20,35,15,18,11,7,26,55,66,1
ae4e2852,29,17,15,11,3,18,27,9,13,4,9,27,56,44,0
ae59b359,44,29,16,25,3,14,29,15,14,6,8,39,83,21,0
ae7d0ecd,0,0,0,0,0,0,1,1,1,0,1,0,0,17,3
aef6e670,46,28,23,19,4,24,34,10,19,11,8,30,76,61,4
af0c835b,0,0,0,0,0,0,1,1,1,0,1,0,0,0,0
b052b8bf,0,0,0,0,0,0,1,1,0,0,0,0,0,9,3
b0547a87,19,14,7,6,6,9,42,33,15,0,15,13,32,7,0
b0c71810,17,11,8,6,3,8,28,20,8,0,8,3,20,1,0
b2336681,22,13,14,5,3,15,23,8,10,4,6,9,31,23,0
b2791a55,2,1,1,1,0,2,4,2,4,4,0,1,3,6,1
b2bd0f6c,45,23,15,19,11,24,84,60,24,2,22,24,69,15,0
b34c63a5,5,3,0,3,2,1,11,10,3,0,3,4,9,0,0
b49729cb,1,1,1,0,0,1,1,0,2,0,2,0,1,16,3
b4c816a9,0,0,0,0,0,0,1,1,1,0,1,0,0,2,0
b6047994,0,0,0,0,0,0,1,1,1,0,1,0,0,0,0
b666421b,32,14,23,9,0,20,37,17,27,13,14,40,72,107,0
b66d1d8a,14,13,12,2,0,9,17,8,21,13,8,45,59,66,1
b73f17f8,0,0,0,0,0,0,1,1,1,1,0,1,1,1,0
b748968d,59,40,37,21,1,30,50,20,28,3,25,72,131,58,0
b8d22478,21,12,11,8,2,4,13,9,14,0,14,9,30,2,0
b92edde2,10,7,9,1,0,2,6,4,7,3,4,11,21,5,0
b94b8be1,38,20,12,17,9,13,49,36,15,1,14,10,48,6,0
b99bec05,28,20,11,17,0,11,21,10,13,3,10,16,44,21,0
bc0bfc64,8,2,3,3,2,3,14,11,3,0,3,6,14,9,0
bc224243,4,3,1,3,0,1,5,4,4,0,4,1,5,0,0
bc7b4580,62,37,37,23,2,35,61,26,29,8,21,37,99,49,0
bc9479b9,2,0,0,2,0,0,2,2,0,0,0,1,3,5,0
bcf1b2e9,2,1,2,0,0,2,4,2,1,0,1,1,3,9,2
bdedd861,0,0,0,0,0,0,1,1,0,0,0,0,0,0,0
be13e5a8,0,0,0,0,0,0,0,0,0,0,0,0,0,1,0
be47b750,13,6,0,4,9,1,14,13,16,1,15,7,20,15,0
beae3a73,52,30,25,19,8,26,84,58,58,12,46,36,88,53,0
beb391dd,70,41,39,24,7,33,58,25,23,5,18,43,113,47,2
bef0a7ac,6,4,1,4,1,5,13,8,9,2,7,3,9,17,0
bf4c41f9,8,2,2,2,4,1,7,6,11,0,11,2,10,2,0
bfcef334,2,2,1,1,0,2,4,2,1,0,1,2,4,1,0
c05d65d1,0,0,0,0,0,0,0,0,1,0,1,0,0,0,0
c0b3669f,22,14,1,13,8,7,27,20,15,2,13,8,30,26,0
c0f706f3,0,0,0,0,0,0,1,1,2,0,2,2,2,0,0
c20bdcd7,79,43,39,32,8,35,58,23,26,3,23,45,124,53,0
c26a3918,42,27,23,17,2,30,63,33,23,2,21,35,77,61,0
c39b09e3,4,1,1,1,2,0,1,1,1,0,1,1,5,1,0
c4173f1a,0,0,0,0,0,0,0,0,0,0,0,0,0,3,1
c4bbea9f,15,10,10,4,1,3,14,11,34,26,8,38,53,104,3
c631f952,1,1,1,0,0,1,4,3,0,0,0,0,1,9,1
c64c01fc,2,2,0,1,1,1,3,2,2,0,2,0,2,0,0
c6e5d20f,37,22,13,20,4,18,38,20,33,7,26,39,76,21,2
c7526c18,34,16,15,16,3,12,31,19,24,10,14,16,50,26,0
c76b7567,36,17,8,16,12,12,58,46,44,5,39,22,58,2,0
c795c408,17,12,13,4,0,8,11,3,27,13,14,59,76,91,2
c801616a,54,37,25,26,3,30,90,60,31,8,23,38,92,39,0
caef7840,0,0,0,0,0,0,2,2,0,0,0,0,0,1,0
cb4e852b,0,1,0,0,0,0,0,0,0,0,0,2,0,0,0
cb9ec45d,25,19,13,9,3,9,16,7,13,4,9,25,50,32,0
cc41f558,34,21,18,12,4,17,39,22,25,5,20,39,73,30,0
cc588cbe,0,0,0,0,0,0,0,0,0,0,0,0,0,0,0
cc77354e,88,51,31,49,8,40,74,34,36,13,23,34,122,51,0
cc83b74d,6,2,1,3,2,2,11,9,11,2,9,6,12,19,1
cc972842,0,0,0,0,0,0,0,0,0,0,0,0,0,0,0
ccb1c3af,7,2,6,0,1,4,8,4,3,0,3,5,12,2,0
ccce7025,31,21,18,12,1,14,26,12,31,21,10,57,88,126,2
cdc4458b,1,0,0,1,0,1,1,0,1,0,1,0,1,0,0
ce492295,9,6,8,0,1,5,10,5,8,5,3,17,26,22,0
ce4f40c7,87,47,40,42,5,32,65,33,20,4,16,52,139,26,1
ce50fd99,17,10,5,5,7,9,24,15,19,1,18,3,20,9,0
cecbce23,2,1,2,0,0,2,3,1,0,0,0,4,6,17,1
cf1ef7ec,5,4,3,2,0,4,7,3,3,0,3,4,9,12,0
d14229f3,6,3,2,2,2,2,8,6,7,0,7,1,7,2,0
d21e361a,9,5,5,4,0,2,13,11,12,0,12,6,15,2,0
d33c706e,12,7,1,9,2,8,18,10,11,1,10,4,16,34,0
d3ce9f1f,6,5,4,1,1,2,5,3,4,1,3,5,11,5,0
d4133fa1,0,0,0,0,0,0,2,2,0,0,0,1,1,0,0
d4d35152,24,12,10,13,1,20,40,20,6,1,5,14,38,8,0
d4fa7d01,16,11,14,2,0,11,14,3,8,7,1,10,26,57,0
d504b3e1,7,4,1,4,2,2,9,7,10,1,9,4,11,6,0
d5575935,40,23,19,17,4,11,47,36,14,2,12,25,65,21,1
d56b9520,0,0,0,0,0,0,0,0,0,0,0,0,0,0,0
d5f2f82b,27,21,14,10,3,15,26,11,21,9,12,27,54,75,2
d63e2912,81,48,34,35,12,39,51,12,21,5,16,54,135,65,0
d7bf3d19,4,2,3,1,0,1,3,2,2,1,1,1,5,1,0
d8992b84,36,24,17,15,4,17,42,25,17,4,13,19,55,9,1
d9764034,26,11,17,9,0,15,27,12,18,11,7,27,53,66,1
d9a66c60,3,2,1,2,0,0,5,5,4,2,2,0,3,4,0
da4d670f,0,0,0,0,0,0,0,0,0,0,0,0,0,0,0
db7849ca,28,13,12,10,6,14,37,23,15,3,12,11,39,24,0
db87a2c4,0,0,0,0,0,0,0,0,0,0,0,0,0,0,1
ddcc9e22,0,0,0,0,0,0,0,0,0,0,0,0,0,0,0
de40e38c,3,3,1,1,1,2,3,1,1,0,1,1,4,4,0
de488e56,53,34,30,17,6,27,54,27,26,5,21,36,89,65,0
dff153a4,30,18,12,15,3,19,39,20,17,5,12,17,47,13,1
e0f3a1f6,32,18,20,11,1,18,31,13,25,19,6,42,74,79,0
e1df6989,55,28,25,26,4,21,69,48,20,4,16,33,88,15,2
e288d4b3,24,16,9,9,6,12,29,17,7,1,6,17,41,25,0
e2f9bb5f,30,15,19,10,1,16,40,24,15,0,15,25,55,12,1
e34fc66d,2,1,1,1,0,2,2,0,1,1,0,2,4,6,0
e3ad3368,0,0,0,0,0,0,0,0,0,0,0,0,0,0,0
e3d0b0c4,44,29,30,12,2,26,37,11,35,25,10,49,93,122,2
e3e05edf,13,6,10,3,0,9,15,6,3,2,1,8,21,26,1
e4448c8c,0,0,0,0,0,0,1,1,0,0,0,1,1,1,0
e472a6f6,1,1,0,1,0,0,1,1,3,1,2,1,2,1,0
e4b72e34,47,29,25,14,8,23,43,20,19,4,15,30,77,34,1
e50623a0,3,2,0,3,0,1,3,2,0,0,0,6,9,2,0
e53ab10b,0,0,0,0,0,0,0,0,0,0,0,0,0,0,0
e54a9890,20,11,10,8,2,11,19,8,9,1,8,17,37,36,0
e6777e6b,36,27,29,7,0,24,37,13,23,13,10,31,67,108,5
e768de1f,81,52,36,40,5,42,85,43,37,6,31,49,130,36,0
e7986081,2,2,0,1,1,0,4,4,4,2,2,5,7,9,0
e90dc1d5,1,0,1,0,0,1,4,3,1,0,1,0,1,0,0
e97150c0,31,19,21,10,0,20,39,19,26,11,15,44,75,81,1
ea02beaf,34,16,22,7,5,15,36,21,22,2,20,51,85,40,1
ea0aa7e0,45,22,25,13,7,28,44,16,30,9,21,26,71,57,0
ea0ff634,8,6,2,4,2,3,11,8,7,2,5,11,19,22,0
ecada4fc,0,0,0,0,0,0,0,0,0,0,0,0,0,10,0
ed45c4a5,93,59,31,55,7,43,85,42,32,2,30,28,121,21,1
edbe46dc,3,2,3,0,0,3,5,2,0,0,0,1,4,14,4
edd1466a,39,24,29,8,2,16,35,19,19,10,9,21,60,41,0
edd81e2a,57,37,38,19,0,24,44,20,31,14,17,44,101,112,0
eedea60b,0,0,0,0,0,0,0,0,0,0,0,0,0,0,0
ef2e5e1a,9,6,5,4,0,4,8,4,5,2,3,5,14,7,0
ef7cd87a,28,12,10,16,2,14,31,17,17,2,15,22,50,19,0
ef9c1c95,114,68,47,61,6,53,122,69,39,10,29,76,190,49,0
f00de885,1,1,1,0,0,1,2,1,1,0,1,1,2,20,1
f066022d,65,39,48,16,1,42,74,32,34,23,11,65,130,125,0
f18d7ab2,18,12,12,5,1,9,12,3,11,3,8,20,38,35,0
f329ec76,1,1,1,0,0,1,2,1,2,0,2,1,2,0,0
f3600c02,33,17,14,15,4,16,43,27,14,2,12,20,53,18,0
f36c432f,8,4,2,3,3,3,13,10,1,0,1,3,11,3,0
f36d5624,5,4,3,1,1,4,9,5,5,1,4,7,12,4,0
f449640d,21,17,9,11,1,6,13,7,7,0,7,6,27,11,1
f45f9427,7,6,4,2,1,6,8,2,8,2,6,5,12,8,0
f4bc42b1,17,14,7,6,4,7,23,16,10,0,10,9,26,3,0
f5044e54,67,39,33,31,3,25,83,58,50,14,36,29,96,31,1
f54d2149,49,36,24,23,2,27,49,22,19,6,13,36,85,33,4
f5b6fb78,42,26,27,12,3,22,48,26,33,10,23,42,84,70,0
f5c8b425,12,5,6,2,4,1,24,23,5,1,4,2,14,2,0
f5efb153,29,17,18,11,0,16,24,8,44,34,10,54,83,115,1
f6496133,24,17,3,15,6,11,24,13,17,2,15,15,39,1,0
f6b94e8d,23,12,17,6,0,13,19,6,12,8,4,14,37,39,1
f76022e7,2,0,0,1,1,1,1,0,0,0,0,2,4,0,0
f7691f63,39,27,17,19,3,24,55,31,23,1,22,18,57,10,0
f81ef10d,72,45,17,39,16,35,106,71,35,3,32,23,95,5,2
f83c8d6c,7,3,3,2,2,1,1,0,2,0,2,1,8,3,0
f8405304,9,7,2,6,1,4,9,5,4,0,4,3,12,0,0
f86ca403,35,20,19,11,5,10,18,8,9,2,7,42,77,11,0
f8ce97ca,8,7,4,4,0,5,14,9,4,0,4,5,13,8,1
f98b15f0,12,7,7,3,2,7,14,7,6,0,6,12,24,3,0
f9921b7f,1,0,0,1,0,0,0,0,0,0,0,0,1,0,0
f9d5908e,52,35,20,24,8,26,68,42,14,4,10,23,75,26,1
fa18c72e,38,25,12,18,8,8,28,20,23,1,22,11,49,3,0
fb14aa28,23,9,4,13,6,9,22,13,16,1,15,4,27,26,0
fbbb9269,47,33,24,17,6,27,45,18,31,8,23,49,96,57,2
fbf76716,16,9,8,6,2,7,25,18,9,0,9,4,20,5,1
fbf83734,0,0,0,0,0,0,0,0,0,0,0,0,0,4,2
fc4cf6a7,35,25,19,11,5,20,34,14,19,7,12,33,68,52,1
fc62f087,16,11,9,5,2,8,13,5,15,8,7,25,41,36,0
fcb27134,32,22,21,6,5,9,18,9,17,11,6,31,63,41,0
fcb38f57,0,0,0,0,0,0,0,0,0,0,0,0,0,7,2
fcbcbd94,5,3,1,2,2,2,11,9,4,1,3,5,10,8,0
fd2bc67d,10,5,6,4,0,3,7,4,6,4,2,10,20,20,0
fe296c72,13,7,11,1,1,11,16,5,8,6,2,24,37,51,0
fe6c1add,0,0,0,0,0,0,0,0,0,0,0,0,0,0,0
feb5d3ab,55,34,33,15,7,32,59,27,23,6,17,25,80,43,0
feb5d972,45,29,19,21,5,20,38,18,24,4,20,27,72,16,0
ff0ab48c,38,26,19,16,3,18,36,18,27,9,18,31,69,69,2
ff3a6a60,1,1,1,0,0,0,1,1,1,0,1,1,2,0,0
ff800ed8,28,16,11,15,2,16,28,12,18,5,13,25,53,26,0
ffec9769,7,5,3,1,3,3,12,9,4,1,3,1,8,6,0
fffea3e5,44,25,9,24,11,11,26,15,18,1,17,11,55,1,0
