id,Tkl,TklW,Def 3rd,Mid 3rd,Att 3rd,Tkl.1,Att,Lost,Blocks,Sh,Pass,Int,Tkl+Int,Clr,Err,recov
00891164,37,27,22,13,2,12,19,7,31,16,15,38,75,85,0,120
00a8d210,56,36,25,25,6,28,53,25,22,4,18,32,88,30,1,109
01870104,2,2,0,1,1,0,9,9,1,1,0,0,2,1,0,8
01becd60,2,1,1,1,0,0,1,1,0,0,0,2,4,1,0,4
01fd01e8,14,6,10,3,1,9,11,2,12,4,8,10,24,43,1,44
02bcaf8e,4,2,1,2,1,0,3,3,3,0,3,3,7,0,0,18
032f894e,3,0,0,1,2,1,5,4,6,0,6,8,11,2,0,35
03e91055,0,0,0,0,0,0,0,0,0,0,0,0,0,0,0,2
0400dd2f,1,0,0,0,1,0,4,4,2,0,2,0,1,0,0,16
04ac78d2,4,1,3,0,1,2,6,4,11,9,2,4,8,26,0,29
04bb2b06,9,5,4,4,1,4,8,4,5,0,5,2,11,8,0,24
0512a60a,26,11,14,9,3,13,17,4,14,5,9,16,42,33,0,94
061266cd,4,4,2,2,0,1,4,3,1,0,1,1,5,3,0,14
065dc209,9,5,1,5,3,3,8,5,11,3,8,3,12,11,0,40
06c48679,32,20,13,13,6,15,29,14,20,11,9,26,58,45,0,93
06df8256,10,8,6,4,0,5,10,5,9,6,3,17,27,40,1,67
07ace8c3,0,0,0,0,0,0,0,0,0,0,0,0,0,0,0,3
0810b6df,0,0,0,0,0,0,0,0,0,0,0,0,0,1,0,8
08511d65,28,20,12,14,2,19,34,15,22,9,13,20,48,52,2,127
08f5afaa,0,0,0,0,0,0,1,1,0,0,0,0,0,7,2,36
095e4199,9,3,3,3,3,5,12,7,5,0,5,2,11,2,0,51
0a63446f,27,18,16,8,3,18,26,8,13,3,10,26,53,30,1,67
0af4dcf0,2,1,2,0,0,2,2,0,0,0,0,0,2,0,0,5
0b2c9aec,13,6,5,5,3,6,17,11,6,2,4,4,17,7,0,48
0b4d8274,6,2,3,1,2,2,4,2,4,0,4,2,8,1,0,29
0b4f388a,14,8,2,6,6,5,9,4,12,3,9,5,19,12,0,53
0be95d34,22,14,7,8,7,8,16,8,10,1,9,7,29,3,0,49
0bfca6a1,22,13,14,6,2,12,25,13,18,4,14,18,40,21,0,84
0cbc8baa,50,28,33,14,3,31,48,17,21,5,16,13,63,41,0,96
0d7b6576,7,3,2,3,2,3,7,4,9,2,7,3,10,4,0,33
0e12089d,0,0,0,0,0,0,0,0,0,0,0,0,0,6,3,21
0e46fa2f,4,2,0,2,2,1,6,5,6,1,5,3,7,2,0,13
0e7ccfc4,14,6,9,1,4,10,19,9,7,2,5,7,21,17,0,41
0ed063d6,13,8,8,4,1,6,8,2,10,1,9,17,30,24,0,92
0f8418aa,20,13,7,11,2,9,23,14,13,4,9,5,25,15,0,75
0f86995c,0,0,0,0,0,0,1,1,0,0,0,0,0,0,0,2
0ff630d0,22,16,15,3,4,10,18,8,9,1,8,18,40,30,1,71
102c9665,14,12,9,5,0,7,9,2,3,1,2,11,25,22,0,45
104b4ad3,3,2,1,2,0,0,6,6,1,0,1,1,4,2,0,14
10dd88f9,11,3,2,6,3,6,24,18,10,0,10,8,19,7,0,60
10f0fdd3,31,17,13,13,5,6,15,9,15,2,13,21,52,17,0,113
114bbdee,1,1,1,0,0,0,0,0,0,0,0,1,2,3,0,4
11f54bd5,2,1,1,0,1,2,6,4,0,0,0,1,3,1,0,9
1361e5bc,8,4,3,4,1,6,7,1,1,0,1,6,14,5,0,19
1467af0d,59,35,28,28,3,32,61,29,31,6,25,19,78,6,2,121
148e136f,43,27,14,18,11,17,36,19,32,2,30,13,56,6,1,94
15944afd,10,4,4,5,1,4,10,6,8,3,5,6,16,9,0,38
16aa7d4c,29,17,18,11,0,12,21,9,25,11,14,36,65,49,1,84
17e25e72,1,1,0,1,0,0,0,0,1,0,1,1,2,0,0,4
1880614f,23,12,8,12,3,9,21,12,7,0,7,14,37,7,0,82
18ebca4b,2,1,0,2,0,0,4,4,2,0,2,0,2,5,0,6
19053e31,18,10,8,6,4,6,15,9,13,2,11,12,30,4,0,79
1956b948,31,19,18,9,4,16,42,26,19,1,18,10,41,10,0,102
1961b2aa,26,16,7,13,6,13,34,21,16,5,11,9,35,12,1,99
19ba6c6d,5,2,0,3,2,0,7,7,6,3,3,2,7,10,0,20
1a066e69,23,12,16,5,2,12,16,4,25,15,10,31,54,73,0,84
1a248246,20,11,5,9,6,9,24,15,11,1,10,6,26,5,0,73
1a2935f6,12,11,12,0,0,10,15,5,8,6,2,15,27,34,1,53
1a6b7ea4,27,16,11,12,4,10,17,7,9,3,6,15,42,21,0,62
1a85bcdb,53,33,28,17,8,27,42,15,20,5,15,47,100,50,0,101
1b5b32d2,1,0,0,1,0,1,2,1,0,0,0,0,1,0,0,0
1b729a98,0,0,0,0,0,0,0,0,0,0,0,0,0,1,0,1
1bd5bdc4,0,0,0,0,0,0,0,0,0,0,0,0,0,0,0,0
1bfb6fef,44,30,19,20,5,25,45,20,27,5,22,12,56,45,0,125
1d2d5cc8,0,0,0,0,0,0,1,1,0,0,0,0,0,6,2,40
1d383c10,0,0,0,0,0,0,1,1,1,0,1,0,0,1,0,2
1d5c96f8,56,30,29,18,9,31,48,17,26,5,21,29,85,30,1,110
1ddbc7ca,64,39,38,21,5,39,57,18,25,1,24,35,99,28,1,107
1df4a109,26,12,9,15,2,11,16,5,14,6,8,14,40,8,0,58
1e52971c,46,27,20,19,7,26,51,25,24,5,19,21,67,12,0,130
1e7aea56,0,0,0,0,0,0,2,2,0,0,0,0,0,8,1,34
1e93fc5d,1,1,1,0,0,1,1,0,0,0,0,0,1,0,0,2
1ec7e1c5,8,7,5,3,0,3,3,0,4,3,1,5,13,12,0,13
1f6298f2,0,0,0,0,0,0,0,0,1,0,1,0,0,0,0,2
2054d037,10,6,1,6,3,3,10,7,15,1,14,1,11,17,0,28
20b9f052,0,0,0,0,0,0,1,1,0,0,0,0,0,4,1,29
20e0dd86,42,31,14,14,14,19,35,16,20,3,17,20,62,10,0,111
20e73fac,27,19,10,14,3,11,39,28,28,1,27,20,47,20,0,119
2180c761,7,4,5,1,1,1,4,3,5,3,2,7,14,4,1,28
22396615,1,1,0,1,0,0,1,1,0,0,0,1,2,0,0,2
22bfb57e,9,4,3,6,0,5,14,9,2,1,1,6,15,5,0,24
2321ea6e,52,23,38,11,3,34,45,11,18,5,13,27,79,77,1,144
23c63b7f,6,5,1,2,3,2,5,3,9,0,9,1,7,7,0,49
2434f24a,2,0,2,0,0,2,4,2,0,0,0,0,2,5,0,18
25749008,24,14,7,11,6,6,21,15,16,2,14,17,41,13,0,79
2677a1de,15,9,6,7,2,3,14,11,9,1,8,7,22,9,0,52
279ddf6a,59,35,24,24,11,24,54,30,20,5,15,29,88,13,0,109
28dabd43,2,0,2,0,0,2,2,0,1,0,1,1,3,7,1,13
29939a1d,22,15,12,8,2,11,28,17,13,1,12,20,42,8,0,85
29c02c9f,19,11,9,8,2,10,13,3,14,2,12,10,29,10,0,32
2acd49b9,22,16,15,5,2,12,16,4,15,5,10,13,35,12,0,96
2acf0cd7,40,19,9,22,9,15,31,16,22,5,17,17,57,27,0,105
2b1bed19,52,32,20,28,4,30,52,22,24,5,19,32,84,13,3,130
2b471f99,32,21,11,14,7,12,18,6,13,5,8,11,43,20,0,62
2c0f8e9e,16,13,4,9,3,1,9,8,6,0,6,2,18,3,0,55
2c70d915,2,0,1,1,0,1,3,2,0,0,0,3,5,1,0,3
2ccd89a3,9,6,4,3,2,3,6,3,3,0,3,4,13,11,0,20
2d22cea7,8,7,3,4,1,3,7,4,5,1,4,4,12,1,0,20
2db2fd7b,2,0,1,1,0,1,3,2,4,2,2,5,7,15,0,9
2f9e4435,41,26,20,11,10,15,28,13,24,6,18,19,60,21,0,90
2fa2a875,0,0,0,0,0,0,1,1,0,0,0,0,0,0,0,9
300ec91c,0,0,0,0,0,0,1,1,1,0,1,0,0,0,0,1
3010aefb,11,5,5,2,4,3,9,6,7,3,4,7,18,4,0,29
30144daa,14,11,5,6,3,10,19,9,13,0,13,3,17,8,0,38
30af8b93,49,36,28,18,3,29,48,19,19,6,13,14,63,45,1,139
31626657,65,38,41,22,2,24,53,29,22,4,18,17,82,21,0,110
31822f8c,6,3,0,4,2,1,11,10,16,1,15,1,7,11,0,60
3189f61a,64,36,28,29,7,32,48,16,25,7,18,34,98,23,3,183
321a71a7,36,23,23,11,2,16,25,9,20,12,8,29,65,61,0,117
32c2d95f,65,38,38,24,3,33,42,9,54,19,35,47,112,85,1,181
32f3d97e,0,0,0,0,0,0,2,2,3,1,2,0,0,1,0,5
3322e296,7,5,4,3,0,4,8,4,3,0,3,1,8,7,0,15
34a88e3e,15,10,4,6,5,10,17,7,7,0,7,2,17,1,0,40
35516eac,17,12,8,7,2,8,20,12,7,0,7,11,28,4,0,46
357103bd,20,10,4,9,7,10,33,23,23,3,20,12,32,16,1,72
3670aa71,0,0,0,0,0,0,0,0,0,0,0,0,0,0,0,2
3681cfff,10,4,7,2,1,4,12,8,15,11,4,20,30,48,0,59
3708e9fa,46,27,13,25,8,20,52,32,21,0,21,27,73,10,0,115
37143438,3,1,0,1,2,2,2,0,3,0,3,1,4,0,0,7
374fbf7d,18,10,4,10,4,9,21,12,4,1,3,13,31,9,0,67
375622c5,39,24,23,12,4,23,55,32,15,4,11,14,53,10,0,187
3814120d,0,0,0,0,0,0,0,0,0,0,0,0,0,2,0,4
3916b09c,9,7,4,2,3,7,15,8,9,1,8,15,24,17,0,39
3935e52e,36,25,22,9,5,15,22,7,15,1,14,28,64,21,0,113
3975195f,25,12,17,4,4,17,27,10,13,3,10,17,42,29,0,104
397ba086,10,3,1,7,2,2,5,3,6,2,4,4,14,9,0,28
39b326ed,15,12,8,6,1,11,19,8,6,1,5,8,23,5,0,34
3a24769f,10,5,4,2,4,5,8,3,5,1,4,4,14,5,0,41
3b029691,35,17,11,18,6,15,51,36,16,3,13,15,50,10,0,122
3b676989,1,0,0,0,1,0,0,0,0,0,0,0,1,0,0,2
3bd65247,14,9,4,9,1,3,8,5,9,0,9,2,16,0,0,28
3befc2b6,88,52,56,27,5,56,94,38,39,17,22,58,146,135,1,113
3c6bbbab,29,20,16,12,1,18,25,7,13,6,7,31,60,28,0,64
3cdfc63e,5,5,5,0,0,5,11,6,23,17,6,20,25,65,1,103
3d214e5f,0,0,0,0,0,0,0,0,1,0,1,0,0,17,3,17
3dd738a1,14,6,6,3,5,5,14,9,5,0,5,13,27,20,0,48
3eaf8817,1,0,1,0,0,0,1,1,1,0,1,0,1,4,0,8
3ecc8c5f,29,17,19,10,0,12,22,10,31,19,12,39,68,72,2,129
3ef0fa48,15,8,6,4,5,4,13,9,4,1,3,3,18,2,0,25
3f319bb9,40,17,29,11,0,25,36,11,37,29,8,39,79,114,0,133
40221fa7,35,18,24,5,6,18,29,11,18,4,14,22,57,27,0,87
40774c6b,12,8,4,7,1,3,7,4,8,1,7,1,13,3,0,16
40ef7347,41,31,19,16,6,18,43,25,28,0,28,17,58,4,0,89
41eebdf5,28,15,14,12,2,7,10,3,19,5,14,36,64,52,1,68
42276181,17,8,4,10,3,7,21,14,9,1,8,8,25,0,0,73
42fd9c7f,6,2,0,2,4,2,9,7,4,0,4,4,10,3,0,37
4315f30d,4,3,3,1,0,1,5,4,10,6,4,13,17,25,1,42
433dc9a2,23,12,15,6,2,16,28,12,8,1,7,7,30,14,0,58
43e7a164,40,26,27,13,0,18,31,13,36,13,23,44,84,111,3,110
4534a352,4,2,3,1,0,3,5,2,6,2,4,6,10,14,1,33
45cce300,0,0,0,0,0,0,1,1,1,0,1,0,0,0,0,0
462475ed,5,4,1,4,0,3,9,6,3,1,2,2,7,7,0,21
46359159,20,12,10,8,2,12,26,14,5,0,5,4,24,12,0,50
46750e9c,2,1,2,0,0,2,2,0,0,0,0,0,2,0,0,7
468fdbad,7,6,4,3,0,5,12,7,2,1,1,5,12,3,0,16
46faabfa,2,0,0,2,0,0,3,3,2,0,2,1,3,2,0,9
477e50ce,0,0,0,0,0,0,0,0,0,0,0,0,0,0,0,0
47c609d5,0,0,0,0,0,0,0,0,2,0,2,0,0,1,0,3
489e80e3,57,34,25,28,4,30,53,23,35,4,31,18,75,10,0,122
48b28bfd,21,15,7,12,2,8,18,10,13,0,13,19,40,7,0,55
48d5bd33,10,4,2,5,3,4,9,5,5,0,5,1,11,5,0,37
49070d66,29,17,18,9,2,16,33,17,8,6,2,18,47,34,0,72
49136c42,16,8,9,6,1,8,13,5,18,9,9,21,37,36,0,65
4a56052c,37,23,9,21,7,15,29,14,14,4,10,26,63,23,2,148
4a5e83ad,9,4,4,5,0,2,9,7,5,1,4,7,16,1,0,30
4a987ffa,0,0,0,0,0,0,1,1,3,0,3,0,0,0,0,0
4b792f35,0,0,0,0,0,0,0,0,0,0,0,1,1,0,0,1
4b96c347,5,2,1,1,3,3,6,3,3,0,3,2,7,1,0,17
4be0b467,1,0,0,1,0,1,3,2,2,0,2,0,1,1,0,6
4ca4f601,32,18,7,15,10,12,39,27,20,5,15,12,44,9,0,70
4db5915d,11,6,5,3,3,2,4,2,5,0,5,6,17,6,1,39
4e0afc5d,22,16,13,7,2,11,14,3,8,3,5,4,26,4,0,27
4e47507a,3,2,0,2,1,0,1,1,0,0,0,0,3,1,0,9
4e7db402,0,0,0,0,0,0,1,1,0,0,0,0,0,12,2,24
4fb18ca4,3,0,1,2,0,3,5,2,0,0,0,2,5,2,0,0
5065d67d,4,3,3,1,0,1,2,1,2,1,1,2,6,4,0,5
5069b796,17,13,12,5,0,12,16,4,14,9,5,16,33,52,2,66
508a9011,1,1,0,1,0,0,0,0,0,0,0,0,1,0,0,1
50ac8941,0,0,0,0,0,0,0,0,0,0,0,1,1,1,0,5
5148dcc5,25,11,7,9,9,13,24,11,15,2,13,14,39,6,0,58
5167c97e,20,14,8,7,5,9,15,6,21,7,14,28,48,25,0,70
51c30111,26,12,6,17,3,18,27,9,21,7,14,21,47,18,0,135
5219ab4a,27,17,10,12,5,11,27,16,17,2,15,19,46,26,1,95
52cd0e88,0,0,0,0,0,0,0,0,0,0,0,0,0,0,0,1
5313ed43,20,8,6,13,1,8,23,15,11,3,8,17,37,9,0,133
531a4aa8,30,22,15,13,2,9,17,8,18,6,12,18,48,45,0,81
53af52f3,0,0,0,0,0,0,2,2,1,0,1,1,1,7,0,16
546bb36e,25,14,13,11,1,10,28,18,17,4,13,18,43,24,0,63
547a72ad,6,4,5,0,1,4,6,2,4,0,4,2,8,4,0,12
562a4799,11,6,4,5,2,9,14,5,7,3,4,13,24,26,1,33
563fcd6b,18,13,10,6,2,12,26,14,8,0,8,5,23,5,0,61
5680bf3f,6,4,2,1,3,3,3,0,9,1,8,7,13,7,0,26
56ae428b,27,15,18,8,1,14,21,7,35,24,11,39,66,129,0,109
574aa9ec,0,0,0,0,0,0,0,0,0,0,0,0,0,0,0,0
576817b7,15,11,9,5,1,6,11,5,4,2,2,8,23,8,0,35
57e3f0c7,16,8,9,4,3,8,17,9,15,0,15,1,17,1,0,61
58ae47b2,4,3,1,2,1,2,7,5,4,0,4,0,4,2,0,39
595e6f3e,12,8,5,3,4,6,12,6,14,1,13,5,17,27,0,32
59948ef7,13,7,1,10,2,7,19,12,16,0,16,11,24,5,0,63
5a6b06cd,1,1,0,0,1,0,0,0,0,0,0,0,1,0,0,2
5b146df3,28,16,22,4,2,14,22,8,28,13,15,39,67,92,0,124
5b1bf5e3,0,0,0,0,0,0,0,0,0,0,0,0,0,1,0,1
5b3cfa12,0,0,0,0,0,0,2,2,1,0,1,3,3,0,0,2
5b479568,1,1,0,0,1,0,4,4,0,0,0,0,1,1,0,6
5b4bc323,33,21,21,10,2,19,35,16,13,2,11,24,57,29,2,83
5b92d896,10,4,1,8,1,5,12,7,10,0,10,4,14,2,0,27
5b9512c5,24,16,15,6,3,12,15,3,29,17,12,42,66,53,0,146
5bf26efc,0,0,0,0,0,0,0,0,0,0,0,0,0,0,0,3
5c42e7ce,6,5,5,1,0,1,5,4,2,2,0,2,8,8,1,9
5cb215fc,25,11,20,5,0,10,15,5,14,12,2,17,42,61,1,65
5ceba7fc,11,10,2,6,3,6,20,14,14,2,12,14,25,7,0,84
5d0e0a1f,60,32,35,16,9,29,41,12,31,7,24,22,82,52,0,121
5d8d7454,13,8,7,3,3,7,12,5,8,1,7,14,27,13,1,44
5d9577aa,6,4,1,5,0,2,3,1,3,0,3,6,12,1,0,22
5e080f73,2,0,1,1,0,0,3,3,3,0,3,2,4,2,0,7
5e22e2a4,29,16,8,18,3,14,30,16,10,3,7,15,44,14,0,107
5e5249c8,30,14,13,10,7,19,31,12,12,0,12,11,41,17,0,98
5e6355f8,2,0,1,0,1,1,2,1,0,0,0,1,3,0,0,3
5ea8ef20,29,14,6,17,6,10,28,18,9,3,6,19,48,11,0,111
5f3eaaf5,16,9,5,7,4,5,9,4,8,1,7,5,21,3,0,82
5fdcb075,22,16,8,14,0,12,26,14,17,4,13,13,35,25,0,54
6043997c,15,10,9,4,2,7,7,0,12,10,2,8,23,48,1,70
60d90c55,1,0,1,0,0,1,1,0,2,0,2,0,1,8,0,37
6191093d,34,23,13,14,7,13,34,21,20,1,19,14,48,6,0,121
61b77d0a,6,4,2,2,2,2,5,3,0,0,0,0,6,5,0,12
627b570a,1,0,0,0,1,1,2,1,0,0,0,0,1,0,0,1
62e02107,6,4,4,2,0,5,6,1,2,1,1,2,8,3,0,9
636247ca,10,7,3,4,3,7,14,7,11,2,9,5,15,0,0,17
6388e356,34,18,17,12,5,23,31,8,30,10,20,24,58,40,1,108
645a3363,30,17,10,14,6,13,38,25,14,2,12,11,41,8,1,94
64ba07c0,25,18,11,12,2,15,17,2,16,3,13,9,34,22,0,41
64c14d49,33,19,15,12,6,18,44,26,20,2,18,19,52,18,0,89
64f69877,7,3,0,5,2,1,3,2,2,0,2,2,9,0,0,20
652d4c37,23,16,7,13,3,13,32,19,14,2,12,16,39,11,0,101
654f49ca,1,0,0,1,0,0,2,2,3,1,2,0,1,1,0,10
65c55288,10,7,5,5,0,3,5,2,6,3,3,7,17,14,0,23
65fcf987,4,2,2,1,1,0,2,2,1,0,1,0,4,1,0,13
6605d143,12,7,3,6,3,5,11,6,15,3,12,10,22,10,0,52
6763f716,8,5,5,3,0,3,6,3,5,1,4,16,24,16,1,26
67f649be,0,0,0,0,0,0,0,0,0,0,0,0,0,1,1,9
68a26d51,27,19,11,13,3,14,36,22,22,1,21,21,48,5,0,108
69384e5d,22,14,6,9,7,9,19,10,7,1,6,4,26,1,1,62
698f11e3,18,8,9,8,1,8,14,6,21,7,14,17,35,22,0,58
6993927b,21,12,14,6,1,14,27,13,18,10,8,11,32,40,1,67
6a827d8e,34,19,16,14,4,21,27,6,6,0,6,11,45,11,0,41
6a9e4913,0,0,0,0,0,0,0,0,0,0,0,0,0,2,0,0
6b4436ba,0,0,0,0,0,0,1,1,0,0,0,2,2,0,0,6
6b5edd5d,1,0,0,0,1,0,0,0,0,0,0,0,1,0,0,0
6b9960cf,8,5,1,6,1,4,15,11,5,0,5,7,15,3,0,23
6bde367b,33,23,15,13,5,16,44,28,22,3,19,23,56,8,1,152
6d0fe035,15,10,7,7,1,11,17,6,11,1,10,9,24,10,0,59
6d7ede84,2,1,0,1,1,1,2,1,3,0,3,0,2,5,0,11
6de23ab0,28,14,15,12,1,19,26,7,16,9,7,31,59,49,1,60
6e33125f,29,16,18,10,1,14,24,10,30,22,8,26,55,91,0,168
6e7f1353,11,7,4,3,4,1,10,9,11,1,10,11,22,4,0,27
6ea05ca7,2,1,1,0,1,0,1,1,1,0,1,2,4,0,0,11
6f5ec8bb,25,15,12,13,0,8,24,16,14,5,9,18,43,47,1,155
6f806d99,89,54,43,34,12,34,86,52,39,4,35,23,112,31,1,192
705a1642,1,0,0,1,0,1,1,0,1,0,1,0,1,0,0,1
706a60e1,3,1,0,2,1,3,6,3,1,0,1,2,5,1,0,13
7091324a,0,0,0,0,0,0,0,0,0,0,0,0,0,1,0,1
70c52749,15,10,5,8,2,6,9,3,8,2,6,11,26,15,0,43
70d4c949,1,1,0,0,1,1,1,0,0,0,0,0,1,0,0,1
7120a04d,21,10,8,5,8,10,19,9,9,0,9,13,34,2,0,48
7155e3e1,18,7,10,7,1,7,15,8,9,2,7,9,27,2,0,42
71d10572,3,1,1,1,1,1,2,1,5,3,2,2,5,8,0,27
72d4922b,2,1,1,0,1,2,5,3,0,0,0,1,3,7,0,8
7304f3b1,2,0,1,1,0,2,2,0,0,0,0,0,2,0,0,11
740f00ac,44,22,23,16,5,20,46,26,13,1,12,15,59,16,0,133
741418c3,12,7,7,4,1,7,10,3,4,0,4,3,15,2,0,18
745ca0a3,12,6,3,5,4,1,6,5,8,0,8,0,12,2,0,28
7495aba7,11,5,3,7,1,4,5,1,5,1,4,2,13,2,0,12
74d4cec6,2,2,0,1,1,0,2,2,1,0,1,0,2,1,0,4
75438a9a,4,2,1,1,2,2,5,3,9,3,6,8,12,22,0,27
7587446d,3,3,2,1,0,3,4,1,3,1,2,3,6,3,0,11
75f1ed80,48,30,37,11,0,30,43,13,22,9,13,23,71,78,2,159
770d7eb8,17,7,14,3,0,12,21,9,5,3,2,11,28,16,0,49
779847d6,50,34,40,8,2,29,43,14,30,16,14,19,69,77,2,118
7909ffa4,38,17,22,12,4,21,37,16,25,8,17,23,61,27,0,112
796b1c41,35,19,11,20,4,10,31,21,16,2,14,25,60,5,0,97
7978cbf0,35,18,13,18,4,18,33,15,16,1,15,13,48,8,0,92
79a793b7,1,1,0,0,1,1,1,0,0,0,0,2,3,0,0,5
79b2399c,27,16,13,12,2,16,34,18,10,1,9,13,40,17,0,71
7a42d0df,31,14,8,14,9,12,28,16,29,1,28,21,52,27,0,70
7b082ec2,16,12,8,7,1,10,16,6,8,3,5,7,23,15,0,48
7b9a9e25,15,6,7,7,1,8,13,5,14,0,14,7,22,4,0,71
7be7c08b,1,1,0,0,1,0,0,0,1,0,1,1,2,0,0,4
7c2965bb,13,7,5,6,2,5,22,17,10,2,8,5,18,6,0,87
7c3ed041,40,26,28,10,2,22,33,11,39,24,15,47,87,70,0,145
7cdda3bf,28,14,9,14,5,11,22,11,20,2,18,7,35,12,0,62
7d3dfdfd,7,4,3,4,0,4,8,4,4,2,2,6,13,13,0,24
7d704e92,29,17,21,7,1,11,26,15,19,14,5,29,58,67,0,66
7d937aa1,0,0,0,0,0,0,0,0,1,0,1,0,0,0,0,2
7d9397f8,38,19,17,19,2,15,33,18,22,8,14,26,64,27,0,97
7dfbba27,22,10,10,10,2,7,16,9,13,2,11,12,34,12,0,71
7e3e825e,3,2,2,1,0,2,3,1,1,0,1,1,4,3,0,2
7e82a78f,3,2,1,0,2,1,5,4,6,0,6,3,6,6,0,22
7ef972c3,2,0,2,0,0,1,1,0,4,1,3,0,2,1,0,5
7f41ee30,1,0,1,0,0,1,1,0,0,0,0,0,1,3,0,9
7f783431,22,15,11,10,1,10,16,6,13,1,12,6,28,28,0,44
7fecbcdb,15,7,9,5,1,10,10,0,4,1,3,8,23,11,0,30
8104e41e,20,13,4,9,7,9,20,11,23,1,22,13,33,7,0,73
822d51d7,63,30,26,32,5,31,58,27,32,3,29,29,92,24,0,170
82464ce3,35,20,14,18,3,20,36,16,29,7,22,24,59,17,0,152
8299e363,4,2,4,0,0,3,5,2,4,1,3,4,8,7,0,16
83299cc0,21,9,6,14,1,10,22,12,9,0,9,15,36,4,1,77
8332db56,15,8,10,2,3,8,14,6,8,2,6,5,20,6,0,33
834b5c4c,2,1,2,0,0,2,2,0,0,0,0,2,4,17,0,21
836dc4a8,2,1,0,1,1,1,1,0,0,0,0,0,2,0,0,3
83f03b07,23,16,12,8,3,11,21,10,11,5,6,19,42,16,0,60
8499c713,2,2,2,0,0,2,3,1,1,1,0,0,2,0,0,1
85613cf0,1,1,0,0,1,0,1,1,0,0,0,0,1,2,0,4
8577e60a,44,25,12,29,3,18,28,10,31,3,28,28,72,14,0,80
8608f269,0,0,0,0,0,0,0,0,0,0,0,1,1,0,0,0
8652a85c,5,5,1,3,1,2,9,7,6,0,6,1,6,1,0,36
868eaba0,40,23,20,17,3,25,67,42,24,6,18,22,62,17,1,145
86a2ba20,27,18,19,6,2,9,20,11,24,8,16,38,65,30,0,156
86a49468,0,0,0,0,0,0,0,0,0,0,0,0,0,0,0,0
87935cf3,7,3,3,4,0,2,4,2,9,7,2,5,12,25,1,33
87d31635,2,1,1,1,0,1,5,4,0,0,0,1,3,5,0,10
87e9c7cd,8,5,5,1,2,7,15,8,9,2,7,7,15,6,0,24
8827bf46,6,4,1,4,1,3,5,2,5,0,5,2,8,4,0,20
8846a40f,17,7,5,11,1,9,26,17,8,1,7,14,31,11,0,64
88c4d190,10,7,3,6,1,1,21,20,19,2,17,6,16,24,0,39
88f130ed,53,36,37,13,3,29,41,12,30,16,14,22,75,91,1,182
890bc029,0,0,0,0,0,0,0,0,0,0,0,0,0,0,0,0
8a53d24b,4,1,1,2,1,3,5,2,6,1,5,1,5,2,0,6
8bc8829a,24,12,12,6,6,10,14,4,5,1,4,14,38,11,0,43
8ca9415f,1,1,1,0,0,0,1,1,4,0,4,0,1,1,0,4
8d62d31a,10,6,8,2,0,4,10,6,15,11,4,9,19,45,1,69
8dbff17c,13,9,10,2,1,11,21,10,4,3,1,11,24,36,1,38
8eec784d,10,6,2,6,2,4,15,11,10,1,9,13,23,12,0,46
8f325097,38,21,27,9,2,26,36,10,11,5,6,21,59,35,1,62
8f7e6783,2,2,1,0,1,1,2,1,0,0,0,0,2,0,0,13
8fd9996f,22,11,9,10,3,11,14,3,15,10,5,22,44,31,0,105
906baf89,0,0,0,0,0,0,0,0,0,0,0,0,0,0,0,0
909222de,32,17,10,16,6,8,30,22,16,0,16,12,44,8,0,50
90a9cc01,1,1,1,0,0,0,1,1,2,1,1,3,4,0,0,10
90eb507d,21,15,9,7,5,10,20,10,8,4,4,20,41,13,0,84
90f87966,21,16,18,2,1,10,18,8,21,11,10,19,40,79,2,87
90fcf472,4,1,1,2,1,2,5,3,4,0,4,1,5,1,0,19
910e3cad,1,1,1,0,0,1,1,0,0,0,0,0,1,0,0,0
9226aa22,22,11,6,10,6,9,26,17,12,1,11,12,34,1,0,62
923f4dda,0,0,0,0,0,0,0,0,0,0,0,0,0,0,0,1
9260926b,10,7,6,3,1,7,10,3,7,3,4,10,20,20,0,28
928a4a61,37,18,20,11,6,19,35,16,21,5,16,15,52,15,0,72
92b56413,1,1,0,1,0,0,2,2,0,0,0,0,1,0,0,10
92d90c8f,2,2,2,0,0,1,1,0,0,0,0,1,3,0,0,2
92ffb8f9,2,1,1,1,0,1,5,4,7,1,6,1,3,0,0,4
93c942fb,7,5,3,4,0,4,10,6,4,2,2,4,11,5,0,11
942b4f90,9,5,2,1,6,2,9,7,12,0,12,4,13,0,0,37
94f8d10c,0,0,0,0,0,0,0,0,0,0,0,0,0,1,0,0
95192fe4,7,4,4,2,1,2,3,1,0,0,0,2,9,2,0,14
967f34d3,0,0,0,0,0,0,0,0,0,0,0,0,0,0,0,6
96f4ebc0,1,1,0,0,1,0,0,0,0,0,0,0,1,0,0,1
9744ff80,5,4,2,2,1,1,7,6,3,0,3,2,7,0,0,16
99d660b2,48,22,17,22,9,23,60,37,21,4,17,10,58,19,1,140
9b545925,48,31,40,8,0,24,44,20,41,20,21,39,87,95,4,152
9b6f7fd5,5,4,0,5,0,1,3,2,2,0,2,1,6,3,0,10
9bc9a519,13,6,7,3,3,9,15,6,7,3,4,2,15,12,0,27
9bdd8118,57,31,32,21,4,31,48,17,22,7,15,30,87,27,0,158
9c221d14,1,1,1,0,0,1,2,1,6,3,3,7,8,19,0,15
9c2b1f11,2,2,1,0,1,0,2,2,1,0,1,0,2,0,0,2
9d420dad,0,0,0,0,0,0,0,0,0,0,0,1,1,1,1,11
9d498560,6,4,4,0,2,5,8,3,5,1,4,4,10,7,0,18
9daeac61,37,25,26,9,2,14,27,13,18,2,16,19,56,26,1,109
9dbb75ca,34,18,7,12,15,8,23,15,16,0,16,13,47,4,0,63
9e17ccff,0,0,0,0,0,0,0,0,0,0,0,0,0,1,1,4
9e7483ff,32,15,9,19,4,9,20,11,15,1,14,9,41,2,0,50
9f0f4b49,4,2,3,0,1,2,2,0,2,0,2,4,8,4,0,14
9f4a940f,2,2,1,1,0,0,1,1,0,0,0,0,2,0,0,5
9f936061,60,37,39,17,4,33,54,21,32,9,23,32,92,46,1,131
a0415710,5,2,3,2,0,2,6,4,4,1,3,4,9,7,0,26
a08985b8,76,49,26,46,4,36,77,41,38,8,30,40,116,31,0,272
a0d55a09,11,9,3,6,2,3,13,10,11,0,11,9,20,5,0,29
a0f9b535,28,14,7,16,5,18,35,17,14,3,11,19,47,11,0,113
a1232f4e,10,8,4,5,1,6,6,0,10,7,3,11,21,12,0,29
a1390d2f,11,10,1,8,2,8,11,3,11,2,9,1,12,2,2,27
a17a94d6,50,35,25,19,6,28,43,15,22,7,15,36,86,34,0,159
a1dbfcb1,7,4,3,2,2,4,4,0,2,1,1,1,8,0,0,7
a3e1d20d,0,0,0,0,0,0,0,0,1,1,0,1,1,0,0,3
a426a912,2,0,2,0,0,1,1,0,1,1,0,2,4,1,0,13
a45a5d95,9,6,4,4,1,3,10,7,6,0,6,5,14,3,0,35
a4a44eb0,35,16,28,7,0,17,26,9,30,21,9,23,58,115,3,104
a4b1028a,29,19,16,12,1,15,29,14,23,5,18,25,54,46,0,103
a4b798a9,49,26,19,25,5,21,55,34,32,4,28,50,99,35,1,165
a5db0bec,8,3,3,3,2,2,4,2,10,1,9,6,14,3,0,24
a62f8bf1,6,3,1,4,1,1,5,4,2,0,2,4,10,2,0,29
a65c844b,41,22,14,20,7,17,37,20,24,3,21,11,52,19,0,130
a94571f6,0,0,0,0,0,0,2,2,0,0,0,1,1,1,0,1
a94d93be,10,4,6,4,0,5,7,2,15,10,5,12,22,65,1,73
a99138af,9,5,3,5,1,6,12,6,2,1,1,4,13,2,0,23
a9d4c241,36,17,23,10,3,19,28,9,21,8,13,33,69,45,0,112
aad56ca3,21,12,7,6,8,3,17,14,12,0,12,6,27,7,0,57
ac73ec79,31,23,16,6,9,19,29,10,22,9,13,14,45,16,0,61
ad82197c,25,17,10,11,4,13,22,9,38,22,16,42,67,83,1,162
ae11ba3d,3,2,2,1,0,2,5,3,1,0,1,4,7,4,0,8
aef6e670,17,8,9,6,2,9,13,4,12,7,5,12,29,9,1,38
aefa3050,0,0,0,0,0,0,0,0,0,0,0,0,0,1,0,3
af0c835b,42,24,18,18,6,13,40,27,16,2,14,19,61,8,0,98
af3ddb2e,12,5,2,6,4,3,15,12,7,1,6,8,20,11,0,36
af69e7f0,5,4,3,2,0,4,4,0,2,0,2,1,6,1,0,16
afb0c500,0,0,0,0,0,0,1,1,0,0,0,1,1,5,3,32
afe39ca8,22,14,13,7,2,11,25,14,18,1,17,13,35,16,0,54
b003239d,8,4,7,1,0,3,6,3,7,3,4,4,12,35,0,30
b026bbf6,6,2,4,2,0,2,4,2,4,0,4,2,8,3,0,13
b088d5d3,9,4,6,3,0,6,10,4,10,1,9,14,23,13,0,47
b0c71810,14,9,7,4,3,3,12,9,6,0,6,5,19,1,0,36
b20cc590,4,2,3,1,0,2,4,2,2,0,2,6,10,32,0,36
b2336681,31,21,23,7,1,13,20,7,18,11,7,22,53,61,1,167
b2791a55,14,7,7,7,0,8,16,8,15,7,8,13,27,30,0,49
b2bd0f6c,23,10,9,8,6,11,29,18,24,1,23,17,40,7,0,114
b3244eeb,30,21,22,7,1,21,42,21,20,9,11,20,50,33,1,132
b34c63a5,11,6,1,4,6,6,13,7,3,0,3,4,15,0,0,57
b3d76d84,1,1,1,0,0,1,1,0,1,0,1,2,3,3,2,27
b3f8bdef,41,24,15,19,7,17,29,12,15,4,11,16,57,22,0,87
b4ef3fb5,0,0,0,0,0,0,0,0,0,0,0,0,0,0,0,0
b5bb8188,13,8,2,11,0,4,6,2,4,1,3,7,20,6,0,27
b625b241,6,3,3,3,0,1,3,2,1,0,1,2,8,2,0,18
b70afb45,7,5,2,2,3,1,8,7,9,2,7,2,9,13,0,33
b73f17f8,19,13,6,11,2,6,11,5,14,1,13,6,25,3,0,58
b8c1de25,22,13,8,12,2,9,20,11,7,1,6,9,31,4,0,46
b94b8be1,2,0,1,0,1,0,3,3,2,0,2,1,3,0,0,4
b99bec05,37,22,22,10,5,22,47,25,18,6,12,52,89,47,0,151
badcdcae,13,6,4,6,3,4,9,5,5,0,5,4,17,5,0,18
bc7b4580,4,2,1,2,1,4,6,2,2,0,2,3,7,11,0,12
bc7cc472,11,9,3,7,1,2,12,10,8,2,6,10,21,2,0,51
be98f358,5,4,2,1,2,2,3,1,3,0,3,3,8,2,0,11
beae3a73,35,23,12,17,6,16,42,26,23,0,23,7,42,5,0,49
bf4c41f9,9,3,2,4,3,2,10,8,14,1,13,2,11,6,0,38
bfb2056e,0,0,0,0,0,0,0,0,0,0,0,1,1,0,0,3
c03b7266,1,1,1,0,0,1,2,1,0,0,0,1,2,1,0,3
c066d1a5,17,12,8,8,1,13,20,7,9,1,8,7,24,12,1,24
c0c7ff58,44,19,16,23,5,33,56,23,17,1,16,9,53,10,1,100
c2a6033c,23,16,9,6,8,7,31,24,13,1,12,16,39,16,0,95
c3725db2,37,20,24,10,3,17,26,9,25,16,9,29,66,96,0,125
c385bf49,17,11,10,3,4,4,8,4,12,4,8,5,22,10,0,37
c4065f40,10,5,6,4,0,4,9,5,9,4,5,8,18,35,1,29
c4173f1a,0,0,0,0,0,0,0,0,0,0,0,0,0,3,2,11
c43a8336,3,2,2,0,1,0,1,1,1,0,1,4,7,8,0,22
c5908bc4,3,2,1,2,0,0,2,2,1,0,1,1,4,0,0,13
c5adc293,2,1,1,0,1,2,4,2,3,1,2,4,6,6,0,13
c5e6c017,1,1,0,0,1,0,3,3,1,0,1,0,1,2,0,3
c631f952,1,0,1,0,0,0,0,0,0,0,0,0,1,8,1,16
c678ddd7,0,0,0,0,0,0,1,1,1,1,0,1,1,4,0,8
c6e5d20f,40,20,19,19,2,28,33,5,20,8,12,39,79,40,3,111
c76b7567,30,16,14,10,6,16,45,29,28,0,28,6,36,6,0,107
c801616a,19,12,6,10,3,9,24,15,13,1,12,21,40,14,1,74
c8c02ac7,0,0,0,0,0,0,3,3,4,0,4,4,4,1,0,9
c90f380c,4,2,4,0,0,0,0,0,3,0,3,0,4,0,0,4
c9151d66,43,22,21,17,5,21,40,19,15,1,14,24,67,8,0,100
c92c24f0,20,11,15,5,0,13,18,5,23,11,12,24,44,53,0,84
c9f2f83a,5,2,5,0,0,2,4,2,3,3,0,1,6,13,1,17
c9f49454,3,3,0,1,2,2,4,2,2,0,2,1,4,1,0,9
ca6f4846,0,0,0,0,0,0,0,0,0,0,0,0,0,0,0,0
caa7aaea,69,41,24,38,7,40,76,36,42,10,32,21,90,42,0,116
cad3fd4d,3,1,2,1,0,0,5,5,2,0,2,2,5,0,0,8
caef7840,32,17,10,13,9,14,41,27,23,4,19,21,53,10,0,108
cd9b37a3,1,1,1,0,0,0,0,0,0,0,0,1,2,0,0,3
ce50fd99,15,11,3,7,5,7,16,9,17,2,15,5,20,13,0,56
cea59f02,36,23,24,9,3,22,34,12,20,13,7,37,73,38,2,148
cf182add,38,16,14,15,9,15,26,11,21,4,17,17,55,29,0,95
cf1ef7ec,3,2,0,2,1,0,1,1,4,4,0,3,6,11,0,19
cfa49cc1,21,15,12,6,3,11,20,9,10,5,5,4,25,21,0,56
d14229f3,35,18,16,14,5,13,33,20,25,0,25,2,37,7,0,83
d21e361a,17,11,5,10,2,8,13,5,8,0,8,4,21,1,0,33
d33c706e,4,1,2,2,0,1,3,2,1,0,1,1,5,7,0,16
d4d35152,35,20,15,19,1,20,48,28,13,1,12,19,54,11,0,95
d504b3e1,9,5,1,6,2,5,10,5,5,0,5,6,15,0,0,40
d5326924,6,5,0,5,1,0,0,0,2,0,2,0,6,1,0,8
d56b9520,34,21,17,10,7,15,32,17,21,4,17,24,58,21,1,128
d5d22a58,7,5,1,5,1,4,7,3,2,0,2,7,14,3,0,13
d5f2f82b,22,15,11,9,2,14,19,5,29,18,11,20,42,59,2,127
d60cf08d,3,1,1,2,0,1,3,2,5,1,4,3,6,18,0,16
d70ce98e,19,13,1,9,9,7,19,12,8,0,8,0,19,0,0,45
d7547531,0,0,0,0,0,0,0,0,0,0,0,1,1,0,0,1
d75f3980,8,5,4,4,0,7,12,5,6,2,4,7,15,5,0,14
d8c19a60,3,3,3,0,0,2,3,1,0,0,0,5,8,6,0,10
d9764034,32,19,18,14,0,10,23,13,25,17,8,27,59,50,0,88
db3164e1,2,2,2,0,0,2,3,1,0,0,0,2,4,13,0,20
db7849ca,29,19,15,6,8,13,27,14,16,1,15,18,47,12,0,103
db87a2c4,0,0,0,0,0,0,1,1,0,0,0,1,1,0,0,3
dbd3a428,29,15,10,10,9,11,40,29,23,1,22,6,35,2,0,85
dc29b608,0,0,0,0,0,0,0,0,0,0,0,2,2,3,2,11
dd211559,54,30,36,11,7,27,42,15,27,2,25,26,80,62,1,144
de488e56,5,3,5,0,0,4,6,2,9,2,7,8,13,6,0,17
df8d6029,24,16,15,6,3,16,24,8,18,8,10,22,46,77,2,123
dfc5d4fa,3,1,2,1,0,1,2,1,2,0,2,1,4,1,0,4
dff0c299,3,0,2,0,1,3,4,1,2,0,2,2,5,4,0,11
dff153a4,1,1,1,0,0,1,1,0,2,1,1,1,2,0,0,2
e05082d1,15,7,5,9,1,4,9,5,4,0,4,7,22,3,1,37
e0f3a1f6,33,19,24,8,1,18,27,9,22,14,8,42,75,59,0,116
e110ea4b,3,2,2,1,0,1,1,0,2,0,2,2,5,0,0,6
e3844ecb,15,8,5,7,3,6,25,19,8,0,8,5,20,0,0,36
e3e32fbb,10,6,7,2,1,7,11,4,2,0,2,1,11,2,0,12
e4114f5d,0,0,0,0,0,0,1,1,0,0,0,1,1,0,0,1
e42d61c7,40,24,14,16,10,23,38,15,25,1,24,9,49,9,0,94
e4448c8c,1,0,0,0,1,1,1,0,0,0,0,0,1,0,0,3
e472a6f6,48,19,24,17,7,29,38,9,21,4,17,14,62,19,0,127
e546b2e3,20,13,7,10,3,9,25,16,19,2,17,11,31,6,0,78
e54a9890,36,24,18,15,3,13,26,13,26,2,24,14,50,20,0,67
e5c1e0ca,30,18,23,6,1,12,20,8,40,18,22,19,49,122,0,127
e6eadfb8,20,13,17,3,0,10,15,5,6,2,4,8,28,19,1,40
e76cb9cc,31,20,18,12,1,17,23,6,22,12,10,34,65,67,0,126
e7986081,7,4,2,3,2,4,6,2,5,0,5,2,9,6,0,20
e7d59f4f,6,4,0,3,3,3,7,4,4,1,3,4,10,6,0,27
ea0ff634,7,7,1,2,4,3,10,7,8,0,8,6,13,11,0,16
eb0db257,6,3,2,3,1,4,9,5,5,0,5,2,8,3,0,20
eba1e557,14,6,6,7,1,3,7,4,7,2,5,4,18,2,0,25
ed39121c,31,20,19,12,0,12,29,17,19,4,15,23,54,15,0,87
ed45c4a5,58,35,19,33,6,27,51,24,35,7,28,34,92,21,1,184
ed90babd,15,8,3,8,4,4,9,5,13,0,13,5,20,4,0,47
ee45fd85,49,27,19,22,8,27,42,15,27,5,22,34,83,22,1,97
eeba07f8,4,1,1,2,1,1,3,2,1,0,1,3,7,6,0,5
eedea60b,2,1,1,0,1,2,2,0,0,0,0,0,2,10,4,29
ef619b0b,38,19,15,16,7,11,23,12,19,4,15,13,51,13,0,89
ef8ae23b,12,7,6,6,0,4,9,5,12,1,11,11,23,12,0,94
ef9c1c95,89,52,34,43,12,45,91,46,39,7,32,30,119,47,0,202
f00de885,1,0,1,0,0,1,2,1,0,0,0,2,3,8,0,18
f066022d,21,15,17,3,1,16,22,6,29,25,4,18,39,108,2,58
f0661424,73,44,32,31,10,38,57,19,28,6,22,48,121,25,0,125
f19f32b1,0,0,0,0,0,0,0,0,0,0,0,0,0,1,0,6
f20e4cc9,32,22,21,9,2,24,31,7,11,2,9,13,45,12,0,66
f28474a4,4,1,1,0,3,3,5,2,1,0,1,1,5,2,0,4
f323d995,35,22,25,8,2,19,35,16,26,13,13,22,57,82,1,91
f3600c02,10,3,6,3,1,7,16,9,11,2,9,6,16,8,0,38
f41a69e6,1,1,0,1,0,1,3,2,0,0,0,2,3,9,3,24
f4bc42b1,14,6,7,5,2,4,8,4,7,0,7,2,16,3,0,33
f5044e54,56,36,29,24,3,31,71,40,29,6,23,39,95,30,1,166
f527a32c,24,11,12,3,9,10,26,16,11,0,11,5,29,5,0,70
f5c8b425,0,0,0,0,0,0,0,0,2,0,2,0,0,1,0,5
f5dfc256,0,0,0,0,0,0,0,0,0,0,0,0,0,0,0,0
f6496133,6,2,1,4,1,3,4,1,3,1,2,4,10,2,0,9
f6857b4f,0,0,0,0,0,0,0,0,1,0,1,0,0,0,0,1
f7691f63,39,25,20,13,6,30,49,19,24,4,20,14,53,23,0,99
f81ef10d,62,33,19,25,18,33,77,44,29,2,27,22,84,16,0,156
f833a830,10,5,3,5,2,5,23,18,14,0,14,5,15,3,0,27
f8ce97ca,2,2,1,0,1,0,1,1,2,0,2,3,5,2,0,5
f9d5908e,40,19,22,16,2,25,32,7,20,4,16,23,63,12,0,87
faf00ab8,27,14,10,15,2,12,17,5,6,1,5,4,31,3,0,36
fb0ee44e,24,17,3,14,7,10,25,15,9,0,9,9,33,16,0,48
fb14aa28,34,14,10,16,8,9,19,10,21,3,18,4,38,8,0,67
fb3236a7,20,11,11,8,1,12,17,5,19,4,15,27,47,41,0,89
fb4c5b6e,2,2,1,1,0,1,1,0,0,0,0,0,2,1,0,2
fb55f63a,0,0,0,0,0,0,0,0,1,1,0,0,0,0,0,2
fc46aab1,20,9,9,8,3,3,16,13,11,0,11,15,35,5,1,79
fc4cf6a7,47,29,25,18,4,26,36,10,32,8,24,26,73,40,0,104
fcc84a07,39,27,16,21,2,25,41,16,20,2,18,8,47,4,0,75
fd2bc67d,40,24,26,11,3,17,32,15,39,22,17,36,76,93,1,161
fd78b105,0,0,0,0,0,0,0,0,1,0,1,0,0,3,0,6
fdbde523,14,8,2,9,3,4,11,7,6,0,6,3,17,13,0,37
feb5d3ab,21,11,14,7,0,10,27,17,13,5,8,10,31,16,0,50
fed17f5a,11,8,2,7,2,7,14,7,5,2,3,2,13,2,0,48
ff4d0258,1,1,1,0,0,1,1,0,1,1,0,1,2,2,0,3
ff4df82e,5,3,0,2,3,2,6,4,3,0,3,0,5,4,0,19
ffec9769,5,3,2,2,1,0,3,3,2,0,2,1,6,11,0,16
fffea3e5,13,10,3,6,4,8,17,9,6,0,6,4,17,2,0,52
