id,Tkl,TklW,Def 3rd,Mid 3rd,Att 3rd,Tkl.1,Att,Lost,Blocks,Sh,Pass,Int,Tkl+Int,Clr,Err,recov
0027c6cc,13,8,8,5,0,10,11,1,3,2,1,5,18,21,0,23
003a5c72,16,12,9,6,1,10,18,8,7,5,2,15,31,11,0,32
003d7410,0,0,0,0,0,0,7,7,0,0,0,2,2,7,1,6
011d8c56,0,0,0,0,0,0,0,0,0,0,0,0,0,0,0,0
016ff750,2,2,0,1,1,1,7,6,3,0,3,5,7,0,0,16
0174ba21,1,1,1,0,0,1,1,0,1,0,1,2,3,2,0,5
0193a8bf,10,7,3,7,0,2,6,4,10,2,8,5,15,1,0,20
01eb744d,10,8,5,3,2,3,18,15,8,0,8,8,18,5,0,24
02f4b798,1,1,1,0,0,0,2,2,2,1,1,7,8,6,0,4
038aa94a,16,12,13,3,0,8,16,8,11,0,11,13,29,22,0,37
03de83d9,0,0,0,0,0,0,3,3,0,0,0,0,0,1,1,4
03f946ed,1,1,0,0,1,0,4,4,1,0,1,3,4,2,0,19
042d286e,1,1,0,1,0,0,4,4,3,0,3,2,3,0,0,3
0488e833,5,5,2,3,0,1,3,2,3,1,2,7,12,7,0,21
0489db27,2,2,2,0,0,2,2,0,2,1,1,1,3,4,0,5
048a1cbc,1,1,1,0,0,0,0,0,0,0,0,0,1,1,0,1
04f2ed4d,5,4,4,1,0,4,7,3,9,6,3,11,16,24,0,35
053f6e16,1,1,1,0,0,1,1,0,2,0,2,3,4,6,0,11
0557ff4f,15,8,7,5,3,8,11,3,12,4,8,18,33,16,0,32
0562b7f1,0,0,0,0,0,0,0,0,0,0,0,0,0,0,0,1
05a275e0,6,3,4,1,1,4,10,6,5,1,4,7,13,10,0,15
05ad9890,0,0,0,0,0,0,0,0,0,0,0,1,1,0,0,1
05cb19c5,3,3,0,2,1,0,4,4,0,0,0,1,4,1,0,6
05e19d6a,14,10,5,7,2,7,14,7,10,0,10,4,18,6,0,42
061e8e23,1,1,1,0,0,0,0,0,1,0,1,1,2,2,0,2
0630eb63,6,6,1,5,0,1,3,2,5,0,5,4,10,6,0,30
06eae126,0,5,0,0,0,0,0,0,0,0,0,2,0,0,0,0
0711c00f,5,1,4,1,0,3,4,1,3,1,2,5,10,9,0,11
075fe5a3,1,1,1,0,0,0,1,1,2,2,0,2,3,14,0,3
077b773d,1,0,1,0,0,0,1,1,0,0,0,1,2,3,0,14
07a0baa9,11,7,5,6,0,5,11,6,0,0,0,5,16,1,1,20
080ac8d8,12,8,5,4,3,4,9,5,8,3,5,1,13,8,0,17
0810b6df,1,1,1,0,0,1,2,1,0,0,0,1,2,1,0,5
08593525,49,33,24,22,3,16,42,26,17,4,13,29,78,27,0,104
08990838,7,6,5,2,0,2,4,2,6,5,1,11,18,44,0,36
08f5afaa,1,0,1,0,0,1,3,2,0,0,0,0,1,4,1,15
08fe932d,3,3,1,1,1,0,2,2,2,1,1,5,8,8,0,30
0984c5d5,4,3,2,2,0,1,3,2,3,0,3,1,5,3,0,10
099e666f,11,8,8,3,0,7,10,3,5,1,4,4,15,10,0,14
09a9e921,0,0,0,0,0,0,2,2,1,0,1,0,0,3,0,7
09bcc566,5,4,0,3,2,0,1,1,3,0,3,1,6,2,0,22
0a215326,4,4,3,1,0,1,4,3,4,1,3,1,5,1,0,17
0ac94a23,3,2,1,0,2,2,5,3,3,0,3,1,4,1,0,6
0aeeed3f,6,4,2,3,1,0,4,4,7,0,7,3,9,2,0,22
0af4dcf0,0,0,0,0,0,0,2,2,2,1,1,0,0,4,0,8
0b221abd,0,0,0,0,0,0,0,0,0,0,0,0,0,2,1,4
0b2c9aec,0,0,0,0,0,0,0,0,0,0,0,0,0,0,0,1
0b5a292a,2,1,0,2,0,0,0,0,2,0,2,1,3,2,0,8
0b5b8057,2,1,1,1,0,0,1,1,1,1,0,0,2,2,0,5
0be28faf,5,3,4,1,0,1,3,2,3,0,3,6,11,4,0,15
0be3255b,1,1,1,0,0,1,1,0,0,0,0,0,1,4,0,20
0be46103,1,1,0,1,0,1,2,1,3,3,0,1,2,4,0,9
0cd0e21b,4,4,0,4,0,1,2,1,5,0,5,8,12,12,0,34
0d077b88,25,14,11,10,4,5,18,13,9,2,7,15,40,8,0,60
0daa34cc,0,0,0,0,0,0,0,0,1,0,1,2,2,0,0,1
0e5753c7,18,10,10,5,3,9,12,3,9,1,8,5,23,14,1,17
0e61c46b,0,0,0,0,0,0,0,0,0,0,0,0,0,1,0,0
0eeafda5,13,6,11,2,0,3,7,4,10,7,3,13,26,45,1,38
0efacb06,0,0,0,0,0,0,2,2,2,0,2,0,0,5,0,13
0f5e0b8a,11,6,9,1,1,5,7,2,6,0,6,3,14,16,0,41
0f816ae5,4,4,3,0,1,1,1,0,1,1,0,4,8,4,0,9
0f888175,4,3,1,2,1,0,2,2,3,0,3,0,4,5,0,9
0f8bd0a6,4,4,2,1,1,1,4,3,7,2,5,5,9,16,0,24
0f9b8301,9,2,3,5,1,4,10,6,2,0,2,3,12,5,0,42
0fffd034,0,0,0,0,0,0,0,0,0,0,0,0,0,0,0,0
10206347,0,0,0,0,0,0,0,0,0,0,0,0,0,0,0,0
10a81962,4,1,4,0,0,3,6,3,3,1,2,2,6,9,1,10
10d58a78,2,2,1,1,0,1,4,3,4,0,4,2,4,2,0,11
10efd0e1,6,6,4,2,0,2,6,4,3,1,2,0,6,4,0,28
110a95ca,1,1,1,0,0,1,1,0,0,0,0,0,1,2,1,4
119b9a8e,10,9,6,4,0,6,10,4,7,5,2,8,18,34,0,28
11a1a615,3,2,2,1,0,3,3,0,0,0,0,2,5,2,0,0
11c0fa9d,6,3,1,1,4,1,4,3,6,0,6,3,9,0,0,20
120c594d,6,5,3,1,2,2,2,0,1,1,0,4,10,1,0,4
1238a3f9,2,1,1,1,0,1,1,0,0,0,0,1,3,0,0,3
12947ab7,1,1,1,0,0,1,1,0,0,0,0,1,2,0,0,0
12dcbdcc,25,14,12,11,2,14,21,7,14,2,12,7,32,18,0,35
12e6d21a,0,0,0,0,0,0,0,0,5,1,4,2,2,5,0,16
130a7a3f,8,8,4,2,2,4,6,2,2,0,2,1,9,1,0,22
1321d6f0,2,1,1,1,0,2,2,0,1,0,1,1,3,5,0,6
134832c6,2,1,1,1,0,1,1,0,2,0,2,2,4,0,0,4
136e7649,0,0,0,0,0,0,0,0,0,0,0,0,0,1,0,0
1381e699,3,2,2,1,0,2,2,0,4,3,1,1,4,18,0,4
13a78e01,19,12,12,5,2,10,21,11,13,4,9,11,30,24,0,43
13ac19de,9,5,6,2,1,3,11,8,3,0,3,4,13,2,0,65
13b0c150,10,9,5,5,0,3,3,0,8,6,2,8,18,18,0,25
140afefb,0,0,0,0,0,0,0,0,2,0,2,0,0,1,0,3
1432d037,1,0,1,0,0,1,2,1,1,0,1,0,1,0,0,1
1443ca7d,1,0,1,0,0,1,2,1,3,2,1,0,1,5,0,9
144607cc,1,1,0,0,1,0,0,0,0,0,0,1,2,1,0,6
14e8fe86,9,6,5,4,0,4,10,6,9,1,8,5,14,10,0,28
15413fa5,15,8,6,8,1,4,17,13,7,1,6,4,19,4,0,37
1598599e,10,8,4,6,0,4,6,2,2,1,1,7,17,1,1,19
15b949ab,8,7,3,4,1,5,6,1,0,0,0,10,18,3,0,21
15d0c248,18,14,13,4,1,7,15,8,11,7,4,27,45,33,1,51
15e99107,0,0,0,0,0,0,0,0,0,0,0,0,0,0,0,0
15e9c7e6,4,3,2,2,0,1,3,2,4,0,4,1,5,0,1,8
15fd5593,4,3,2,2,0,3,11,8,6,2,4,6,10,3,0,12
16380240,7,6,1,4,2,2,8,6,1,0,1,3,10,1,0,33
163bbd4a,1,0,0,0,1,0,1,1,0,0,0,0,1,0,0,2
16657b95,14,7,3,7,4,0,12,12,5,0,5,4,18,3,0,45
1668b4b1,0,0,0,0,0,0,0,0,0,0,0,0,0,0,0,0
166a981d,4,4,1,2,1,2,2,0,2,0,2,6,10,7,0,14
16952f65,8,4,3,4,1,2,14,12,8,0,8,2,10,3,0,21
169fd162,4,3,2,0,2,2,11,9,5,0,5,2,6,3,0,19
16ceb862,3,2,0,2,1,0,1,1,1,0,1,1,4,4,0,10
17370b95,12,8,9,2,1,6,8,2,3,1,2,5,17,31,0,25
173eb3cd,7,4,3,4,0,3,10,7,3,2,1,4,11,6,0,18
1770bd68,11,8,4,3,4,1,5,4,7,1,6,10,21,8,0,40
1771f2c1,5,4,2,3,0,3,5,2,3,1,2,1,6,3,0,4
17e3e467,6,5,2,3,1,0,3,3,1,0,1,0,6,0,0,13
182c10aa,6,4,2,3,1,1,3,2,3,1,2,3,9,3,0,20
18682b13,5,2,1,4,0,3,4,1,0,0,0,4,9,6,0,7
194ace07,8,3,4,4,0,2,5,3,4,0,4,6,14,8,0,30
197640fd,3,2,2,1,0,1,7,6,6,0,6,3,6,8,0,10
19e4dca5,11,8,9,1,1,7,13,6,12,6,6,20,31,74,0,43
1a105265,0,0,0,0,0,0,0,0,0,0,0,0,0,1,0,2
1a4b9094,28,21,17,11,0,14,27,13,12,2,10,19,47,27,0,75
1a63f024,19,11,9,10,0,4,8,4,8,2,6,11,30,7,0,49
1a799243,40,24,18,19,3,24,48,24,17,2,15,17,57,31,0,98
1a97dc06,4,4,2,1,1,0,4,4,2,2,0,7,11,8,0,11
1aa98b10,0,0,0,0,0,0,0,0,0,0,0,0,0,0,0,1
1bd5735a,10,6,3,5,2,6,9,3,5,0,5,4,14,10,0,23
1bf33a9a,7,6,2,4,1,2,8,6,5,0,5,1,8,0,0,7
1bfdb73a,6,4,4,2,0,3,5,2,3,2,1,8,14,20,0,50
1c37137f,12,5,6,4,2,5,16,11,4,0,4,12,24,24,0,41
1c529186,4,3,2,2,0,1,1,0,3,0,3,0,4,9,0,15
1c639185,10,7,3,6,1,4,10,6,5,1,4,9,19,9,0,38
1c78737d,11,6,5,6,0,2,20,18,7,3,4,11,22,18,0,24
1c98558c,0,0,0,0,0,0,0,0,0,0,0,0,0,5,0,5
1cfd188f,0,0,0,0,0,0,0,0,0,0,0,0,0,0,0,0
1d1691ad,10,9,4,3,3,5,5,0,5,1,4,6,16,12,0,25
1d2d5cc8,0,0,0,0,0,0,0,0,0,0,0,0,0,2,0,3
1d5f96d9,0,0,0,0,0,0,0,0,0,0,0,0,0,1,0,1
1d8e9add,7,4,6,1,0,5,5,0,6,5,1,5,12,14,0,28
1db295e5,8,4,7,1,0,0,0,0,4,4,0,14,22,41,0,29
1de2f2de,9,5,4,3,2,4,9,5,2,0,2,7,16,8,0,14
1e062a01,7,5,2,4,1,0,2,2,8,2,6,7,14,3,0,38
1e064bfb,1,0,1,0,0,1,2,1,0,0,0,0,1,2,0,3
1e29552f,0,0,0,0,0,0,0,0,0,0,0,0,0,0,0,2
1e415dd6,6,3,5,1,0,2,8,6,3,2,1,5,11,19,0,29
1ecb65be,2,2,0,2,0,0,3,3,3,0,3,2,4,1,0,12
1f9bc0d4,1,1,1,0,0,0,1,1,2,0,2,0,1,0,0,2
1fbbfbde,9,7,6,3,0,3,5,2,3,3,0,6,15,19,1,20
1fe67e86,16,15,9,7,0,8,14,6,7,4,3,2,18,18,0,27
20030c06,1,1,0,1,0,1,1,0,3,3,0,5,6,11,0,11
20094685,21,10,5,11,5,7,32,25,10,0,10,7,28,10,0,64
2042d931,3,3,0,3,0,1,1,0,3,0,3,2,5,3,1,8
20730eae,0,0,0,0,0,0,0,0,1,0,1,0,0,0,0,1
2077ae86,0,0,0,0,0,0,0,0,1,0,1,0,0,0,0,2
2079b3cc,8,5,3,3,2,2,9,7,5,0,5,5,13,3,0,33
20c1ef47,4,3,2,1,1,0,2,2,5,0,5,5,9,2,0,17
20dbf9e0,1,1,0,1,0,0,2,2,3,0,3,1,2,0,0,4
213ab9bb,2,2,1,1,0,0,0,0,1,0,1,0,2,2,0,2
2146785a,18,9,10,7,1,9,15,6,3,0,3,10,28,13,0,31
21519148,3,2,0,3,0,1,5,4,3,0,3,5,8,1,0,16
2196d7d2,5,3,3,1,1,0,3,3,3,0,3,3,8,1,0,21
22551915,3,2,1,2,0,1,6,5,3,1,2,8,11,7,2,7
22721b88,35,25,20,9,6,17,29,12,17,4,13,26,61,60,0,64
2277a390,7,5,4,2,1,3,4,1,7,4,3,8,15,16,1,23
22b752ee,3,3,1,2,0,2,2,0,3,1,2,3,6,10,0,10
22bfb57e,3,1,1,1,1,1,2,1,0,0,0,0,3,0,0,7
22cd43d2,3,2,2,1,0,1,2,1,0,0,0,2,5,2,0,7
2306bfde,0,0,0,0,0,0,0,0,1,0,1,5,5,2,1,11
2319ebe3,8,6,4,4,0,5,10,5,5,1,4,2,10,2,0,14
23c63b7f,0,0,0,0,0,0,0,0,0,0,0,0,0,1,0,3
2409762c,2,2,0,2,0,0,2,2,1,0,1,1,3,1,0,14
242dbdeb,8,5,7,1,0,6,8,2,2,0,2,6,14,9,0,16
248be14f,11,4,7,4,0,6,12,6,1,1,0,9,20,19,0,18
24baba9d,20,12,17,1,2,4,10,6,5,0,5,5,25,20,0,36
24e9421b,4,2,1,3,0,1,3,2,2,0,2,1,5,1,0,14
25126342,3,2,1,2,0,1,2,1,7,4,3,3,6,37,1,19
2557c196,1,1,0,1,0,0,0,0,2,0,2,0,1,5,0,2
2567b7b6,11,8,5,6,0,7,22,15,6,0,6,12,23,11,0,59
25736bcf,5,4,2,3,0,4,7,3,5,3,2,7,12,19,0,18
25763990,0,0,0,0,0,0,0,0,1,1,0,1,1,0,0,5
258aff54,8,5,2,6,0,0,2,2,3,1,2,2,10,5,0,16
25c72b36,0,0,0,0,0,0,0,0,0,0,0,0,0,0,0,0
26a796c1,5,4,0,2,3,2,7,5,5,3,2,5,10,4,0,16
26b7d548,2,1,0,2,0,1,2,1,2,1,1,3,5,10,0,5
273c483b,0,0,0,0,0,0,0,0,0,0,0,0,0,0,0,0
27b1390c,2,1,0,0,2,0,0,0,1,0,1,1,3,0,0,4
27d2618c,0,0,0,0,0,0,0,0,0,0,0,0,0,0,0,4
27d34558,0,0,0,0,0,0,0,0,0,0,0,1,1,0,0,5
27d902c8,0,0,0,0,0,0,0,0,0,0,0,0,0,0,0,2
27f0fcda,2,1,1,1,0,0,2,2,3,0,3,2,4,5,0,9
27ff9bdb,1,0,0,1,0,1,1,0,1,0,1,0,1,0,0,1
281659b5,2,2,2,0,0,2,3,1,4,4,0,8,10,26,1,12
283699b4,13,10,6,6,1,5,10,5,5,2,3,10,23,7,0,23
28aeafaa,8,3,6,2,0,6,12,6,5,0,5,8,16,2,0,25
28baf8f6,4,2,0,3,1,1,5,4,2,0,2,0,4,0,0,4
28c2d647,6,5,1,1,4,2,3,1,1,0,1,4,10,12,0,21
29102874,4,2,2,2,0,0,1,1,4,4,0,4,8,21,0,23
293211e1,3,2,1,2,0,2,2,0,3,0,3,0,3,4,0,16
2973d8ff,0,0,0,0,0,0,1,1,1,1,0,0,0,2,0,11
29aee77c,0,0,0,0,0,0,1,1,2,1,1,1,1,0,0,1
29ef0f49,4,3,0,3,1,1,4,3,1,0,1,1,5,3,0,15
29f7cfd9,1,1,0,0,1,0,1,1,3,0,3,1,2,2,0,4
2a1beb34,9,4,1,6,2,1,11,10,12,1,11,15,24,6,0,33
2a6cd437,2,2,0,2,0,0,0,0,3,2,1,4,6,6,0,9
2a82aa85,6,3,2,3,1,2,4,2,1,0,1,0,6,0,0,12
2b16cb1a,0,0,0,0,0,0,2,2,3,0,3,2,2,2,0,15
2b3efa4a,7,6,5,2,0,3,6,3,3,3,0,4,11,7,0,11
2b59d76f,10,8,5,4,1,4,8,4,7,1,6,10,20,9,0,32
2b83fa49,1,1,1,0,0,1,1,0,3,1,2,3,4,3,0,19
2b9fdeea,15,11,5,8,2,5,15,10,11,0,11,2,17,6,0,44
2bd83368,1,0,0,1,0,0,0,0,0,0,0,0,1,0,0,0
2c0f8e9e,0,0,0,0,0,0,0,0,0,0,0,0,0,0,0,5
2c125b75,4,3,1,2,1,1,2,1,3,0,3,2,6,0,0,14
2ccd89a3,18,13,15,2,1,8,13,5,4,1,3,15,33,25,0,39
2cd3d3ce,7,5,2,5,0,1,4,3,5,0,5,2,9,0,0,23
2d3b60c1,0,0,0,0,0,0,0,0,1,1,0,2,2,6,0,9
2d49b833,14,11,7,7,0,4,12,8,7,1,6,14,28,28,0,25
2d970560,2,2,2,0,0,2,4,2,0,0,0,0,2,4,0,5
2deaf8b2,2,2,1,1,0,1,2,1,2,1,1,2,4,3,1,15
2e06f387,0,0,0,0,0,0,0,0,0,0,0,0,0,0,0,1
2e2ec9cf,2,2,2,0,0,2,3,1,2,0,2,4,6,5,0,8
2e3596d1,7,5,3,4,0,4,5,1,2,1,1,6,13,15,0,24
2e8fc160,3,3,1,1,1,2,4,2,1,0,1,1,4,0,0,2
2ebc1b44,9,5,3,3,3,0,3,3,5,0,5,10,19,3,0,18
2f3452eb,1,1,1,0,0,0,2,2,0,0,0,2,3,0,0,13
2f557579,0,0,0,0,0,0,2,2,2,0,2,1,1,0,0,7
2f798b41,0,0,0,0,0,0,0,0,1,0,1,0,0,10,0,4
2f94b2a0,3,1,1,2,0,0,2,2,7,0,7,4,7,4,0,14
2f9c21da,4,1,4,0,0,3,8,5,9,2,7,10,14,3,0,44
2fd78b8e,4,3,0,4,0,2,6,4,0,0,0,1,5,3,0,4
2ff964a0,2,1,1,1,0,2,2,0,0,0,0,1,3,0,0,3
302acf38,0,0,0,0,0,0,0,0,0,0,0,0,0,0,0,0
3061e1ec,0,0,0,0,0,0,1,1,0,0,0,2,2,5,0,13
30643ce2,0,0,0,0,0,0,0,0,2,0,2,2,2,3,0,6
30c220c3,8,5,4,4,0,6,10,4,4,0,4,4,12,1,0,18
314a0ea4,4,4,4,0,0,3,8,5,3,0,3,4,8,2,0,30
314bdac5,13,4,6,5,2,4,21,17,9,3,6,11,24,6,0,48
314c2af0,0,0,0,0,0,0,1,1,2,0,2,0,0,1,0,7
319322cd,12,9,10,2,0,6,8,2,9,7,2,8,20,15,1,28
31d7f557,8,4,2,5,1,2,5,3,4,1,3,2,10,4,0,10
31daff3a,5,5,4,0,1,3,6,3,2,1,1,3,8,1,0,12
31e3ab68,0,0,0,0,0,0,0,0,0,0,0,0,0,2,0,8
3200c583,13,5,5,7,1,8,13,5,4,0,4,5,18,4,0,27
321a71a7,7,5,3,3,1,2,2,0,7,4,3,18,25,9,0,15
3233eefd,0,0,0,0,0,0,0,0,2,2,0,4,4,10,0,5
323b698f,8,3,3,5,0,0,1,1,1,0,1,3,11,0,0,12
32c0491f,4,4,3,1,0,3,6,3,1,0,1,0,4,4,0,20
33072e69,3,2,1,0,2,0,1,1,3,0,3,1,4,3,1,17
33332e0b,7,5,2,4,1,0,7,7,2,2,0,11,18,14,0,30
33591ff0,0,0,0,0,0,0,0,0,0,0,0,0,0,0,0,0
3376a776,4,4,1,2,1,3,3,0,1,1,0,6,10,9,0,16
3392603d,0,0,0,0,0,0,1,1,0,0,0,0,0,1,1,11
339fe0e8,0,0,0,0,0,0,1,1,0,0,0,0,0,2,1,11
33c7af24,2,1,1,1,0,2,2,0,1,0,1,6,8,1,0,7
33d38e32,0,0,0,0,0,0,2,2,3,0,3,1,1,0,0,1
346d51d9,11,6,5,5,1,4,9,5,3,0,3,5,16,4,0,17
3470f44e,0,0,0,0,0,0,0,0,0,0,0,0,0,0,0,2
3480cb6b,18,9,12,4,2,10,20,10,7,2,5,12,30,12,0,55
348e0505,0,0,0,0,0,0,0,0,2,2,0,0,0,3,0,3
3493992e,2,1,1,1,0,0,2,2,0,0,0,1,3,1,0,10
34bf7740,1,1,0,1,0,0,1,1,3,0,3,0,1,2,0,2
34c3ec17,7,5,2,5,0,2,3,1,0,0,0,1,8,0,0,22
35375f7c,1,1,0,1,0,1,1,0,0,0,0,0,1,1,0,1
35862524,11,7,5,6,0,4,9,5,9,2,7,9,20,8,0,26
35bec436,2,2,1,0,1,0,0,0,1,0,1,1,3,3,0,3
35dd6d80,47,37,34,9,4,33,49,16,9,3,6,21,68,46,0,47
3626daea,7,5,2,5,0,2,7,5,7,1,6,6,13,10,0,41
36a3ff67,2,1,0,2,0,1,4,3,2,0,2,2,4,0,0,10
36d320ec,2,1,1,1,0,0,1,1,2,2,0,0,2,4,1,3
36f288ba,3,3,3,0,0,2,6,4,4,4,0,1,4,7,0,7
3708e9fa,9,8,1,7,1,5,17,12,4,1,3,8,17,1,0,40
375622c5,7,4,5,2,0,2,7,5,1,0,1,2,9,0,0,20
3799e138,15,13,5,7,3,10,24,14,5,0,5,13,28,11,0,58
37f606f0,4,3,0,3,1,2,7,5,2,0,2,4,8,2,0,12
3811e046,2,1,0,2,0,0,1,1,3,0,3,1,3,1,0,9
3904e745,5,3,1,3,1,2,3,1,4,0,4,7,12,19,0,31
390eb94b,2,2,1,1,0,2,2,0,1,0,1,0,2,0,1,3
3935e52e,7,5,5,2,0,5,10,5,5,0,5,2,9,6,1,20
394c5d32,3,2,1,2,0,1,5,4,5,2,3,8,11,6,0,25
3959661b,2,1,1,1,0,1,2,1,3,0,3,0,2,1,0,5
3a8b9635,0,0,0,0,0,0,0,0,0,0,0,1,1,1,0,4
3ad17caa,1,1,1,0,0,0,0,0,1,0,1,0,1,0,0,5
3ad56bf8,3,3,3,0,0,2,5,3,2,1,1,3,6,15,0,8
3b333ac3,15,11,10,3,2,8,16,8,8,3,5,10,25,15,0,35
3b57f7f8,3,3,2,1,0,1,8,7,5,0,5,19,22,12,1,42
3b99b9e1,1,1,0,1,0,0,0,0,1,1,0,1,2,2,0,3
3c285843,0,0,0,0,0,0,1,1,0,0,0,1,1,6,1,7
3cd9e95a,0,0,0,0,0,0,1,1,0,0,0,0,0,0,1,10
3cefcaef,6,4,4,1,1,5,9,4,2,0,2,6,12,11,0,28
3cfc870f,3,1,1,0,2,1,2,1,3,0,3,4,7,0,0,17
3d0fd3d7,0,0,0,0,0,0,0,0,0,0,0,0,0,0,0,2
3d13d9e4,0,0,0,0,0,0,0,0,0,0,0,0,0,0,0,0
3d227f54,0,0,0,0,0,0,0,0,0,0,0,0,0,0,0,0
3d68d631,1,0,0,1,0,0,0,0,1,0,1,1,2,1,0,6
3d7b7d68,0,0,0,0,0,0,1,1,0,0,0,0,0,0,0,5
3da610eb,8,3,5,2,1,2,6,4,4,0,4,5,13,1,0,21
3db34c8e,8,7,2,3,3,2,9,7,2,0,2,1,9,7,0,14
3dfc70ed,0,0,0,0,0,0,0,0,0,0,0,1,1,0,0,2
3e092724,4,4,1,3,0,1,2,1,1,0,1,2,6,0,0,23
3e587547,4,2,3,1,0,4,7,3,1,0,1,1,5,2,0,3
3ead85f9,12,10,7,4,1,4,7,3,4,1,3,6,18,41,0,40
3eb0f2df,0,0,0,0,0,0,2,2,1,1,0,2,2,3,0,6
3ecc11d8,11,8,7,4,0,6,8,2,4,3,1,7,18,22,0,31
3ef0fa48,2,2,1,0,1,1,6,5,7,1,6,6,8,4,0,31
3effaa34,7,2,0,5,2,1,7,6,3,0,3,2,9,8,0,31
3f2d59fe,19,14,14,5,0,8,20,12,7,0,7,16,35,47,0,49
3f30b506,4,3,2,2,0,3,4,1,4,2,2,8,12,11,0,15
3f359b33,4,4,2,2,0,2,3,1,6,5,1,4,8,26,0,21
3faa1780,4,4,1,3,0,3,6,3,4,0,4,2,6,0,0,8
3fc45c73,3,2,2,1,0,3,4,1,2,0,2,3,6,5,0,25
404a2746,4,2,2,2,0,2,2,0,2,1,1,3,7,24,0,15
40f0ed6c,5,3,2,2,1,2,6,4,2,0,2,2,7,3,0,5
410c2fbc,2,0,2,0,0,0,0,0,13,13,0,2,4,30,0,10
4114f306,6,5,3,3,0,2,6,4,1,0,1,0,6,1,0,17
414f7c7d,0,0,0,0,0,0,0,0,1,0,1,0,0,1,0,1
41582151,14,10,9,4,1,9,15,6,8,2,6,11,25,15,0,24
418befe0,10,7,7,3,0,5,6,1,3,0,3,4,14,8,0,5
41afd8cf,12,6,9,3,0,3,9,6,5,3,2,12,24,9,0,32
42276181,2,2,0,1,1,1,3,2,2,0,2,1,3,1,0,9
423e3d0b,3,1,0,3,0,0,3,3,1,1,0,2,5,2,0,8
4285332d,8,6,6,2,0,3,10,7,5,4,1,13,21,49,0,25
42a6cc47,0,0,0,0,0,0,1,1,1,0,1,0,0,0,0,0
42dcf26d,6,3,4,1,1,2,6,4,3,2,1,6,12,13,0,17
42ec696a,0,0,0,0,0,0,0,0,0,0,0,0,0,2,0,4
42fe6b05,4,4,1,3,0,2,3,1,2,0,2,1,5,1,0,10
4315f30d,3,2,2,1,0,1,6,5,2,2,0,5,8,6,0,21
4326c2a9,0,0,0,0,0,0,0,0,0,0,0,1,1,0,0,0
43309491,0,0,0,0,0,0,1,1,0,0,0,0,0,0,0,1
435f829f,0,0,0,0,0,0,0,0,1,1,0,0,0,1,0,2
4383b0da,2,1,0,1,1,0,0,0,0,0,0,1,3,0,0,5
438ae11e,11,7,5,4,2,6,9,3,4,1,3,5,16,5,0,23
43cd8b69,0,0,0,0,0,0,4,4,0,0,0,0,0,1,0,10
43d249bd,7,4,3,4,0,3,5,2,4,1,3,3,10,4,0,33
441950f5,4,2,2,2,0,1,5,4,3,1,2,2,6,3,0,11
4431aed2,0,0,0,0,0,0,1,1,1,0,1,0,0,2,0,20
4442fbcd,20,16,5,13,2,9,21,12,10,1,9,13,33,11,0,34
44865466,7,4,5,2,0,4,7,3,3,0,3,13,20,11,0,29
448a3608,1,0,0,0,1,0,1,1,0,0,0,0,1,3,0,2
44f050bc,3,1,2,1,0,1,2,1,1,0,1,3,6,16,1,3
450ad405,8,6,3,4,1,3,5,2,6,1,5,4,12,14,1,37
45db685d,1,0,0,1,0,1,1,0,0,0,0,0,1,0,0,3
46152b69,9,2,2,7,0,2,6,4,4,1,3,5,14,2,0,18
46a8347f,3,1,1,2,0,2,3,1,0,0,0,3,6,8,0,9
46d50339,11,9,9,2,0,9,11,2,7,1,6,5,16,20,1,17
47064058,1,1,1,0,0,1,1,0,0,0,0,0,1,3,0,12
4737cebe,2,2,1,1,0,1,1,0,2,0,2,1,3,2,0,21
474cf8e0,1,1,1,0,0,0,1,1,1,1,0,1,2,0,0,2
4760b2f2,3,2,3,0,0,3,5,2,9,7,2,12,15,43,1,23
47a34c4f,11,8,5,5,1,5,13,8,13,2,11,15,26,15,1,70
4806ec67,1,0,1,0,0,1,1,0,0,0,0,1,2,1,0,4
4841ba80,0,0,0,0,0,0,1,1,0,0,0,0,0,1,0,6
488350bf,3,3,1,2,0,1,2,1,2,0,2,0,3,1,0,10
48add958,6,4,1,4,1,1,5,4,1,0,1,4,10,0,0,17
491d3ad0,0,0,0,0,0,0,1,1,0,0,0,1,1,1,0,4
493924a7,16,13,9,6,1,4,9,5,7,3,4,9,25,26,0,29
494bff86,1,0,1,0,0,1,4,3,1,0,1,2,3,2,0,6
49ea92be,12,12,3,6,3,5,8,3,13,1,12,12,24,2,0,38
49fe9070,2,2,1,1,0,0,6,6,8,0,8,1,3,1,0,19
4a895384,10,8,6,2,2,6,8,2,17,16,1,13,23,38,2,22
4a97f4c2,9,6,3,5,1,4,12,8,5,0,5,4,13,1,0,27
4aea5077,47,29,19,23,5,26,38,12,24,9,15,22,69,52,0,80
4bd414c1,0,0,0,0,0,0,0,0,2,1,1,1,1,7,0,11
4c07f0e8,18,17,10,5,3,7,15,8,15,4,11,17,35,13,1,53
4c45cdc2,6,6,1,5,0,4,17,13,5,0,5,7,13,3,1,33
4c54b6ec,3,1,2,0,1,1,1,0,0,0,0,1,4,3,0,2
4c5e78da,6,6,2,3,1,1,7,6,5,0,5,3,9,6,0,34
4c6facae,6,5,3,3,0,1,3,2,2,0,2,5,11,3,0,29
4c78b5ed,21,16,5,12,4,13,27,14,8,0,8,17,38,9,0,82
4c82730b,19,9,6,9,4,6,19,13,7,0,7,9,28,0,0,32
4cc82fe1,11,7,8,3,0,4,6,2,10,6,4,12,23,36,1,25
4d478e8b,11,9,7,4,0,6,12,6,5,0,5,5,16,3,0,25
4d64b28e,0,0,0,0,0,0,0,0,0,0,0,0,0,1,0,2
4dedd469,5,4,2,2,1,3,7,4,11,2,9,13,18,32,0,27
4e034598,0,0,0,0,0,0,0,0,0,0,0,0,0,3,0,2
4e0afc5d,9,6,7,2,0,2,6,4,6,2,4,8,17,12,1,16
4e219ad2,5,3,1,2,2,2,12,10,3,1,2,4,9,0,0,28
4e3f5992,13,11,5,7,1,7,17,10,7,0,7,8,21,14,0,40
4e6dbac4,11,5,3,4,4,2,9,7,6,3,3,5,16,10,0,28
4e80a8ef,16,11,7,9,0,3,11,8,8,1,7,5,21,8,0,38
4f182a8f,3,3,2,1,0,2,4,2,3,0,3,3,6,0,0,11
50310821,0,0,0,0,0,0,2,2,0,0,0,0,0,0,0,2
504a654c,1,1,0,1,0,0,0,0,0,0,0,0,1,0,0,5
507c7bdf,13,6,7,6,0,7,16,9,7,0,7,4,17,1,0,35
50c1ff86,5,5,5,0,0,3,6,3,4,0,4,5,10,12,0,8
50ccf47d,24,13,15,9,0,10,13,3,9,3,6,14,38,32,0,42
50e14b3c,0,0,0,0,0,0,0,0,0,0,0,2,2,3,0,1
512a52c6,9,8,4,5,0,8,15,7,11,1,10,6,15,11,0,28
518738b4,5,3,0,3,2,0,5,5,2,0,2,4,9,3,0,14
51a3caf1,2,2,1,1,0,2,2,0,1,0,1,5,7,16,0,5
51b41c5c,13,9,2,11,0,2,6,4,3,2,1,19,32,10,0,40
51e9bb3f,4,4,1,2,1,1,4,3,4,1,3,13,17,2,0,17
520c318f,0,0,0,0,0,0,0,0,0,0,0,0,0,0,0,3
5294a83f,10,8,0,8,2,1,15,14,6,0,6,7,17,2,0,35
529f49ab,16,10,14,0,2,10,24,14,12,2,10,14,30,10,0,41
52e101a8,1,1,1,0,0,1,1,0,1,1,0,0,1,0,0,4
52ec54d0,6,3,2,4,0,1,3,2,0,0,0,9,15,23,1,31
532e1e4f,1,1,1,0,0,1,1,0,2,2,0,0,1,2,0,14
53520a67,8,6,6,2,0,2,6,4,5,1,4,5,13,7,0,15
53685aa2,5,4,2,2,1,2,3,1,1,1,0,3,8,6,0,14
53b03dac,0,0,0,0,0,0,0,0,0,0,0,1,1,6,3,11
53de807a,8,8,6,2,0,6,8,2,4,0,4,11,19,11,1,32
53e07d0b,0,0,0,0,0,0,0,0,0,0,0,0,0,0,0,0
54131505,1,0,0,1,0,0,3,3,2,0,2,0,1,1,0,9
54771b10,20,16,12,7,1,15,29,14,8,3,5,15,35,25,0,58
549922a7,0,0,0,0,0,0,0,0,0,0,0,0,0,1,0,0
54b4dc4e,9,5,5,3,1,3,10,7,5,1,4,5,14,3,0,18
54c9ed15,1,0,1,0,0,1,1,0,0,0,0,1,2,10,0,8
54e0c0cc,0,0,0,0,0,0,0,0,2,0,2,0,0,0,0,0
55126f3b,19,11,8,9,2,5,38,33,13,1,12,10,29,13,1,60
555311f2,5,5,1,4,0,0,2,2,1,0,1,0,5,1,0,19
555d5edd,2,2,1,1,0,1,3,2,4,0,4,1,3,1,1,15
5594dfa6,1,1,1,0,0,0,2,2,2,0,2,0,1,0,0,3
5595a4ff,8,7,3,5,0,6,7,1,1,0,1,9,17,17,1,12
5631b735,13,9,2,7,4,3,16,13,24,4,20,10,23,8,0,52
56ae428b,4,3,4,0,0,1,2,1,11,5,6,7,11,29,0,25
5700824a,9,6,5,3,1,1,6,5,3,0,3,2,11,1,0,20
5710a281,29,17,16,10,3,11,24,13,7,1,6,6,35,7,0,44
57ae16f4,8,5,2,3,3,1,6,5,7,0,7,1,9,1,0,17
57f60036,5,5,2,3,0,2,4,2,5,3,2,9,14,22,0,29
583d6c1f,0,0,0,0,0,0,3,3,0,0,0,0,0,0,0,3
58a3b151,0,0,0,0,0,0,0,0,0,0,0,0,0,0,0,0
58ad9383,0,0,0,0,0,0,0,0,1,0,1,0,0,5,0,15
58ae47b2,5,4,1,3,1,3,10,7,5,0,5,3,8,1,0,38
58dda688,7,4,4,3,0,3,7,4,6,3,3,6,13,19,1,34
59b7d823,16,9,6,9,1,8,17,9,6,2,4,8,24,22,0,51
59e6e5bf,2,2,0,1,1,0,0,0,3,0,3,0,2,1,0,1
59f0c185,0,0,0,0,0,0,0,0,0,0,0,0,0,0,0,1
5a1c49d1,2,2,0,1,1,0,1,1,0,0,0,2,4,4,0,6
5a5d394c,0,0,0,0,0,0,0,0,0,0,0,0,0,0,0,4
5a969ba8,5,1,1,4,0,3,4,1,1,0,1,1,6,1,0,4
5ada5385,3,3,2,1,0,2,4,2,2,0,2,1,4,0,0,9
5b0b23dc,10,8,3,7,0,2,7,5,7,3,4,9,19,6,0,31
5b61fba7,0,0,0,0,0,0,0,0,0,0,0,0,0,0,0,1
5b6cf07c,2,1,0,2,0,0,3,3,0,0,0,3,5,2,0,3
5b887c7a,4,4,2,2,0,2,3,1,8,4,4,8,12,24,2,17
5ba3c9cb,5,4,1,4,0,1,5,4,1,0,1,0,5,2,0,5
5be28712,1,1,0,1,0,0,0,0,2,1,1,9,10,4,0,21
5c46e908,6,5,5,1,0,3,6,3,5,2,3,11,17,16,0,15
5c4dc0ff,0,0,0,0,0,0,4,4,4,0,4,1,1,5,0,13
5c7845f6,4,2,2,2,0,1,2,1,1,0,1,1,5,0,0,9
5c899683,2,2,2,0,0,1,2,1,1,0,1,2,4,1,0,8
5caa62a7,12,7,7,4,1,9,24,15,5,0,5,9,21,2,0,30
5cb1d026,30,19,20,5,5,15,29,14,12,2,10,31,61,34,0,53
5cdddffa,22,15,8,11,3,9,19,10,12,3,9,15,37,6,0,79
5ce0b5ba,11,7,2,7,2,2,10,8,11,2,9,15,26,4,0,49
5d0d1ec7,3,3,3,0,0,1,6,5,4,4,0,8,11,22,0,22
5d13b8ab,4,2,1,2,1,2,3,1,2,0,2,0,4,4,0,17
5d2bb85b,3,2,1,1,1,1,4,3,3,0,3,1,4,3,0,13
5d311e8d,2,1,0,2,0,1,2,1,1,1,0,2,4,3,0,7
5d5219b1,2,2,0,1,1,0,5,5,3,0,3,0,2,0,0,20
5db295be,7,6,2,5,0,2,3,1,3,1,2,3,10,1,0,4
5db2faf1,10,7,5,3,2,4,10,6,4,2,2,5,15,24,0,26
5e8936be,0,0,0,0,0,0,1,1,0,0,0,1,1,4,0,9
5e91ddf8,0,0,0,0,0,0,0,0,0,0,0,0,0,0,2,6
5ed9b537,2,2,2,0,0,1,3,2,4,2,2,5,7,21,2,17
5f9970a0,0,0,0,0,0,0,0,0,0,0,0,0,0,1,0,1
5fdd516f,26,19,17,8,1,16,29,13,10,2,8,21,47,26,1,43
601299e9,10,4,6,2,2,3,17,14,4,1,3,9,19,5,0,23
601be846,4,3,2,2,0,2,3,1,1,0,1,3,7,2,0,6
602bb3f7,18,10,10,8,0,11,12,1,7,4,3,10,28,30,1,35
603cb947,0,0,0,0,0,0,1,1,1,0,1,1,1,1,0,10
605873e1,8,5,1,4,3,2,6,4,3,2,1,10,18,7,0,30
60713cb3,0,0,0,0,0,0,0,0,0,0,0,0,0,3,0,4
60963682,6,6,2,2,2,3,5,2,5,5,0,5,11,9,0,8
60e86875,3,2,2,1,0,0,6,6,3,0,3,0,3,2,0,16
60fd5334,3,1,2,1,0,1,2,1,1,1,0,2,5,6,1,12
612cb8d3,2,1,0,2,0,0,2,2,3,0,3,2,4,0,0,15
615c4d8f,8,3,4,4,0,1,10,9,3,0,3,5,13,6,0,25
61ae3d36,5,3,2,3,0,3,6,3,4,0,4,6,11,7,0,17
61b0b44d,4,2,0,3,1,1,2,1,0,0,0,0,4,1,0,10
61f63784,17,13,11,6,0,12,13,1,7,5,2,6,23,34,0,29
6257811f,0,0,0,0,0,0,0,0,1,0,1,0,0,0,0,1
625c144a,0,0,0,0,0,0,0,0,0,0,0,0,0,1,3,15
62a0089e,1,1,1,0,0,0,0,0,1,0,1,0,1,0,0,3
62e4f112,0,0,0,0,0,0,0,0,0,0,0,0,0,0,0,0
63a60d73,5,3,4,1,0,1,2,1,6,4,2,3,8,21,0,10
63fe0133,9,5,6,3,0,2,6,4,6,2,4,9,18,11,0,37
6407ce4d,1,1,0,1,0,0,2,2,2,0,2,1,2,1,0,9
6419c6f7,3,3,2,1,0,3,7,4,2,0,2,7,10,36,1,37
642bb0c6,1,1,1,0,0,0,0,0,1,0,1,0,1,1,0,0
6434f10d,17,15,7,9,1,7,17,10,6,0,6,7,24,7,1,56
6435e737,5,3,3,2,0,0,5,5,6,0,6,6,11,8,0,38
6448e765,0,0,0,0,0,0,1,1,6,4,2,4,4,5,0,10
644faf10,6,3,0,6,0,1,2,1,0,0,0,0,6,0,0,5
64a674d9,6,6,3,1,2,2,2,0,1,0,1,2,8,3,0,19
64ded08c,8,4,5,2,1,1,5,4,2,0,2,5,13,0,0,21
64e801aa,16,11,6,10,0,7,14,7,12,3,9,20,36,19,1,79
64ec2f85,12,9,5,7,0,2,6,4,7,3,4,17,29,6,0,34
6503ae16,0,0,0,0,0,0,0,0,0,0,0,0,0,1,0,5
65166f80,1,1,1,0,0,1,1,0,0,0,0,0,1,1,0,4
6554bb97,2,2,0,2,0,1,3,2,1,0,1,4,6,3,0,13
65adf2db,1,0,0,1,0,0,0,0,0,0,0,0,1,0,0,3
65d750b5,15,12,4,9,2,7,31,24,11,3,8,11,26,5,0,44
6603fed7,4,3,2,1,1,1,3,2,4,0,4,0,4,1,0,11
6613c819,9,8,6,3,0,1,5,4,3,1,2,14,23,11,0,39
668f2f7c,11,7,8,3,0,4,9,5,3,2,1,8,19,17,0,17
676ff98c,0,0,0,0,0,0,1,1,0,0,0,0,0,0,0,0
6800f515,3,2,1,1,1,3,4,1,1,0,1,1,4,0,0,10
6809ec76,5,3,2,3,0,3,6,3,6,0,6,4,9,7,0,30
68252d6d,3,1,0,1,2,0,4,4,4,0,4,5,8,3,0,27
683b919f,3,3,2,1,0,0,2,2,4,0,4,0,3,0,0,4
685857dc,5,3,0,5,0,1,9,8,6,0,6,8,13,1,0,14
68635c10,7,4,3,2,2,1,5,4,4,2,2,11,18,14,0,23
68829001,16,11,5,8,3,7,12,5,3,2,1,4,20,5,0,15
68a87d66,0,0,0,0,0,0,0,0,0,0,0,0,0,0,0,0
692d8bb0,1,1,0,1,0,1,5,4,1,0,1,0,1,0,0,15
69960ac3,4,3,4,0,0,3,3,0,2,2,0,4,8,13,0,15
699fb8db,7,5,4,2,1,3,6,3,3,2,1,4,11,13,0,27
6a5a9744,0,0,0,0,0,0,0,0,0,0,0,0,0,0,0,0
6a99e0b1,9,7,2,7,0,2,23,21,8,0,8,5,14,2,0,43
6b2c894b,12,10,8,3,1,3,7,4,4,4,0,7,19,10,0,31
6b6cbca4,6,4,6,0,0,2,3,1,7,4,3,14,20,24,0,23
6b85f966,7,6,2,4,1,2,4,2,0,0,0,3,10,4,0,9
6b8b53d7,3,2,2,1,0,2,3,1,1,0,1,0,3,0,0,1
6bb2c084,21,12,10,9,2,4,12,8,12,2,10,18,39,10,2,57
6be86f3d,0,0,0,0,0,0,0,0,0,0,0,0,0,0,0,1
6bfaecc4,0,0,0,0,0,0,0,0,0,0,0,1,1,2,0,1
6bff8a73,8,8,6,2,0,5,6,1,2,1,1,9,17,18,0,20
6c228bb6,0,0,0,0,0,0,0,0,0,0,0,0,0,0,0,3
6c6a3300,4,3,3,1,0,2,6,4,4,0,4,5,9,0,0,21
6c6e2719,6,3,3,2,1,5,8,3,4,0,4,4,10,15,0,29
6c7e441a,0,0,0,0,0,0,0,0,1,1,0,1,1,4,0,6
6ca5ec4b,3,1,2,1,0,2,6,4,4,2,2,1,4,0,0,19
6cafd68d,9,8,5,3,1,5,11,6,11,4,7,4,13,9,1,20
6cd38213,0,0,0,0,0,0,1,1,1,0,1,1,1,6,1,5
6ceef869,5,2,5,0,0,2,2,0,6,3,3,4,9,4,0,13
6d3f2898,4,3,2,1,1,3,3,0,1,0,1,2,6,4,0,8
6dce77a5,9,8,4,5,0,3,9,6,10,3,7,16,25,14,0,47
6dfd8f05,3,3,0,3,0,2,2,0,2,0,2,3,6,1,0,6
6e4df551,8,4,2,5,1,4,13,9,5,2,3,9,17,1,0,38
6e5497ca,7,5,0,5,2,0,2,2,2,0,2,0,7,4,0,19
6e7f1353,27,19,10,14,3,9,45,36,19,0,19,10,37,9,0,90
6e8272e0,5,1,1,2,2,0,5,5,2,0,2,7,12,6,0,10
6e905b8d,0,0,0,0,0,0,0,0,0,0,0,0,0,2,0,1
6f4cf369,6,3,6,0,0,3,5,2,1,1,0,9,15,11,0,8
6f5f82c0,2,0,1,1,0,2,4,2,0,0,0,3,5,1,0,8
6f639ec7,9,8,4,5,0,5,14,9,14,1,13,5,14,6,0,47
6fd1ba62,7,5,2,2,3,2,9,7,5,0,5,9,16,1,0,34
705f5269,0,0,0,0,0,0,0,0,0,0,0,0,0,0,0,1
706a60e1,3,1,0,3,0,2,3,1,0,0,0,1,4,1,0,9
70a9cba5,4,3,2,1,1,3,3,0,1,0,1,1,5,3,0,11
70c52749,13,10,8,5,0,6,13,7,13,3,10,9,22,17,0,46
70e5566a,0,0,0,0,0,0,0,0,0,0,0,0,0,0,0,1
71672fa0,0,0,0,0,0,0,0,0,0,0,0,0,0,2,0,3
71a998b9,17,12,10,6,1,5,14,9,10,4,6,15,32,31,0,37
71d5ca31,10,9,9,1,0,2,3,1,7,6,1,16,26,64,0,32
71ec39ef,26,16,9,14,3,8,18,10,15,4,11,17,43,21,0,57
7214c684,0,0,0,0,0,0,0,0,1,0,1,3,3,3,0,9
721608e5,2,2,2,0,0,1,1,0,0,0,0,0,2,0,0,2
729e3e14,4,3,1,3,0,1,3,2,3,1,2,2,6,4,0,18
72c812f3,8,5,2,4,2,2,5,3,1,0,1,3,11,0,0,10
731e29b8,8,3,2,5,1,1,10,9,10,0,10,4,12,1,0,30
73221bb0,2,1,2,0,0,0,0,0,0,0,0,0,2,0,0,1
7352dca8,2,1,1,0,1,0,1,1,1,0,1,1,3,2,0,9
741e058f,1,1,0,1,0,0,1,1,1,0,1,3,4,0,0,5
746b64a7,2,2,2,0,0,0,4,4,10,7,3,8,10,45,0,34
7483d9f9,15,12,9,6,0,7,18,11,14,10,4,20,35,28,0,42
74bafc9c,14,6,5,7,2,5,14,9,5,0,5,5,19,0,0,38
74d70fb5,4,4,2,2,0,2,3,1,2,0,2,3,7,18,0,13
75229233,7,7,4,3,0,1,5,4,5,2,3,14,21,9,0,39
762179d9,3,2,0,2,1,2,4,2,4,0,4,4,7,1,0,16
7628b359,6,4,1,3,2,2,6,4,6,0,6,9,15,9,0,26
76806215,0,0,0,0,0,0,0,0,1,0,1,1,1,4,4,7
768667c0,0,0,0,0,0,0,0,0,0,0,0,0,0,1,0,0
768a35ac,0,0,0,0,0,0,0,0,0,0,0,0,0,0,0,1
76d5857d,4,3,3,1,0,2,5,3,4,3,1,6,10,11,0,12
76d753f8,19,14,6,12,1,4,29,25,7,0,7,8,27,4,0,47
76dd1480,6,5,1,5,0,2,4,2,7,1,6,1,7,2,0,14
76ecfb22,3,3,2,1,0,1,3,2,1,1,0,3,6,2,0,1
7750462c,0,0,0,0,0,0,0,0,1,0,1,0,0,0,1,14
77cf8da0,10,9,6,4,0,6,7,1,7,2,5,4,14,9,0,16
77d7c96f,9,5,6,3,0,3,3,0,5,0,5,7,16,13,0,27
77f278a0,5,2,1,3,1,1,6,5,4,0,4,3,8,2,0,17
781b698a,0,0,0,0,0,0,1,1,1,1,0,0,0,1,0,2
78841da9,0,0,0,0,0,0,0,0,0,0,0,0,0,1,0,1
78952998,5,3,4,1,0,3,10,7,1,0,1,4,9,2,0,10
79019bf4,7,6,2,5,0,4,9,5,3,0,3,9,16,6,0,20
79370f8c,5,2,2,3,0,3,6,3,0,0,0,1,6,0,0,9
794e2914,2,1,1,1,0,2,2,0,0,0,0,2,4,4,0,12
799caf80,6,3,1,2,3,2,4,2,1,0,1,4,10,2,0,12
79b0d6a0,0,0,0,0,0,0,0,0,0,0,0,0,0,1,0,9
79c90e45,3,1,1,1,1,0,1,1,8,3,5,5,8,5,0,12
79ca3e23,5,5,2,2,1,2,4,2,0,0,0,2,7,1,0,13
7a2cf111,7,5,3,4,0,3,8,5,2,1,1,7,14,14,0,13
7aac47fe,4,4,3,1,0,1,1,0,1,0,1,4,8,7,0,5
7abbf224,1,1,1,0,0,0,0,0,1,0,1,2,3,7,0,2
7b4a62af,0,0,0,0,0,0,0,0,0,0,0,0,0,0,0,0
7b66eec0,4,4,2,2,0,3,6,3,11,8,3,14,18,53,0,28
7b9ecf02,2,1,1,1,0,1,3,2,1,1,0,9,11,22,0,15
7beecde1,2,2,1,1,0,1,4,3,3,2,1,4,6,9,0,14
7bfd96fd,3,2,3,0,0,2,2,0,3,1,2,7,10,11,0,24
7c104bb7,2,1,1,1,0,0,4,4,0,0,0,5,7,0,0,24
7c1a0c67,0,0,0,0,0,0,1,1,3,0,3,2,2,5,0,17
7c224498,9,6,6,3,0,5,14,9,10,1,9,12,21,33,0,43
7ca9f0f0,11,10,9,2,0,5,10,5,5,2,3,8,19,2,1,21
7cd78926,26,20,17,8,1,9,18,9,6,1,5,15,41,24,0,58
7d74f9fd,1,0,0,0,1,0,0,0,0,0,0,1,2,1,0,2
7d974435,9,7,4,5,0,6,16,10,5,2,3,9,18,3,0,40
7dca49f6,5,3,0,4,1,2,7,5,6,0,6,3,8,5,0,18
7e56d3db,5,4,3,1,1,2,4,2,4,0,4,4,9,7,0,17
7e925fa3,5,4,3,2,0,4,4,0,2,0,2,5,10,6,0,11
7e927fda,18,14,13,5,0,8,8,0,7,4,3,20,38,49,0,43
7eb97a8e,2,0,0,2,0,1,1,0,2,0,2,0,2,0,0,6
7ebfac0f,2,2,2,0,0,2,3,1,0,0,0,2,4,0,0,3
7f5ca4f8,2,1,1,1,0,2,2,0,0,0,0,4,6,2,0,6
7f609bfc,10,5,8,2,0,7,10,3,5,3,2,15,25,19,0,22
7f78ad23,12,9,10,2,0,4,7,3,5,1,4,6,18,11,0,41
7fd58fe3,13,10,7,6,0,6,20,14,2,0,2,11,24,8,1,40
807e869a,13,7,4,8,1,3,12,9,8,0,8,2,15,5,0,40
808d48f3,16,10,8,7,1,10,14,4,1,1,0,6,22,12,0,23
80a479ab,2,1,0,2,0,0,0,0,1,0,1,1,3,2,0,12
810486a5,20,14,13,7,0,8,12,4,11,7,4,18,38,30,1,15
81442ecb,14,11,7,2,5,4,5,1,7,0,7,2,16,0,0,34
816192f0,3,2,1,2,0,1,2,1,3,0,3,4,7,6,1,5
816cdcbb,2,1,0,2,0,2,4,2,0,0,0,1,3,0,0,6
819f3a54,3,3,2,1,0,2,3,1,3,0,3,3,6,4,0,9
81b013ec,12,9,8,3,1,4,11,7,9,1,8,13,25,6,0,47
81fa2f75,5,4,5,0,0,2,7,5,11,2,9,9,14,10,0,25
8229a21c,22,16,19,3,0,13,20,7,10,4,6,9,31,42,0,38
826313e2,15,7,13,1,1,7,20,13,6,0,6,13,28,28,0,17
82671804,40,20,16,23,1,10,34,24,25,5,20,19,59,40,1,120
8270ccf9,6,4,4,1,1,3,6,3,2,1,1,4,10,8,0,22
82927de4,8,6,2,5,1,2,7,5,9,0,9,3,11,4,0,46
82b1198a,0,0,0,0,0,0,0,0,0,0,0,0,0,3,0,18
833fb62e,4,1,0,2,2,2,2,0,1,0,1,0,4,0,1,10
8395ab90,1,1,1,0,0,0,0,0,1,0,1,3,4,2,0,16
83b9c48f,33,24,13,18,2,10,20,10,9,2,7,23,56,9,0,42
84399660,7,6,2,4,1,4,5,1,1,0,1,5,12,1,0,15
8454388c,10,7,6,3,1,4,6,2,5,1,4,3,13,12,0,14
84549a07,3,3,1,1,1,0,1,1,2,1,1,2,5,2,0,3
84566787,0,0,0,0,0,0,0,0,2,0,2,0,0,0,0,1
8494acc4,0,0,0,0,0,0,1,1,0,0,0,2,2,5,0,8
8497faf7,18,12,7,9,2,7,11,4,3,1,2,9,27,8,0,37
84ad89fa,8,1,5,3,0,5,13,8,4,2,2,17,25,13,0,18
84cef920,19,16,17,2,0,10,15,5,9,3,6,25,44,37,0,35
84e5adcd,2,1,0,0,2,0,2,2,1,0,1,1,3,6,0,18
8530dd74,0,0,0,0,0,0,1,1,1,0,1,0,0,0,0,1
85f8571a,8,6,6,2,0,2,7,5,3,0,3,12,20,31,0,24
85fd00dd,15,11,10,4,1,10,11,1,3,0,3,5,20,14,0,10
86dd16a8,14,8,10,4,0,4,12,8,3,0,3,9,23,18,0,25
8746d5d0,6,3,3,2,1,4,8,4,5,1,4,8,14,10,0,28
87c7c2b1,0,0,0,0,0,0,1,1,0,0,0,0,0,1,0,2
884a8908,6,3,4,1,1,3,4,1,3,0,3,6,12,2,0,23
889b3bd7,0,0,0,0,0,0,0,0,1,0,1,0,0,1,0,3
88a9ea33,0,0,0,0,0,0,5,5,0,0,0,2,2,5,0,7
88b748d2,1,1,1,0,0,1,1,0,0,0,0,0,1,6,0,14
88cd098e,5,4,1,3,1,2,4,2,2,0,2,1,6,0,0,24
88d4144a,13,11,5,7,1,8,14,6,4,0,4,16,29,10,0,21
88e357ef,0,0,0,0,0,0,0,0,0,0,0,0,0,0,0,1
89565ac5,6,4,3,3,0,4,5,1,4,1,3,8,14,3,0,24
896c126c,7,6,5,1,1,4,12,8,1,0,1,5,12,7,0,21
89b2c8a9,0,0,0,0,0,0,1,1,0,0,0,0,0,0,0,1
8a2248b4,0,0,0,0,0,0,0,0,0,0,0,0,0,2,0,5
8a6ab963,0,0,0,0,0,0,0,0,0,0,0,0,0,2,0,7
8b3fd3af,0,0,0,0,0,0,1,1,0,0,0,1,1,0,0,5
8c3c640c,5,4,1,4,0,1,2,1,5,2,3,3,8,0,0,25
8cc29864,1,1,0,1,0,0,0,0,1,1,0,4,5,5,0,17
8ce063f9,2,1,0,2,0,1,1,0,4,0,4,4,6,1,0,9
8cfcf5bb,2,1,2,0,0,1,1,0,0,0,0,3,5,4,0,10
8d3bca49,1,1,1,0,0,1,1,0,0,0,0,0,1,1,0,2
8d3d3b0a,1,1,0,1,0,0,0,0,0,0,0,0,1,0,0,2
8da74c05,1,1,0,1,0,0,0,0,0,0,0,5,6,2,1,6
8dbff17c,13,8,10,2,1,9,17,8,11,8,3,24,37,82,1,89
8e19242c,0,0,0,0,0,0,1,1,0,0,0,0,0,1,0,1
8e92be30,0,0,0,0,0,0,0,0,1,0,1,0,0,0,0,0
8ed1d91b,15,12,10,5,0,10,15,5,11,7,4,8,23,11,0,37
8f056768,28,21,13,10,5,12,36,24,15,2,13,11,39,14,0,73
8f299faf,9,9,8,1,0,7,10,3,5,3,2,10,19,20,0,21
8f4d116f,9,6,5,4,0,4,8,4,12,7,5,24,33,51,0,47
8f696594,5,5,2,1,2,3,10,7,4,0,4,3,8,1,0,35
8ff07990,2,2,1,0,1,2,2,0,1,0,1,1,3,2,0,11
903b3b77,6,6,6,0,0,1,4,3,9,8,1,19,25,47,0,37
90624e56,0,0,0,0,0,0,2,2,2,0,2,2,2,1,0,2
908eea67,5,4,3,2,0,2,4,2,6,5,1,8,13,15,0,20
9109185e,1,0,1,0,0,0,0,0,0,0,0,0,1,0,1,23
91538ba3,6,3,5,1,0,2,4,2,10,7,3,15,21,33,0,28
917ddcdf,0,0,0,0,0,0,1,1,2,1,1,0,0,1,0,8
91899ca8,3,3,2,1,0,1,4,3,5,4,1,10,13,13,0,23
921f6058,11,7,10,1,0,5,8,3,9,6,3,12,23,22,0,24
92232aad,8,4,4,3,1,2,3,1,3,0,3,4,12,21,0,11
9228b07c,6,2,3,3,0,2,10,8,5,2,3,2,8,4,0,11
923f4dda,2,2,0,1,1,0,1,1,1,0,1,0,2,4,0,5
92432bc6,56,35,13,37,6,21,46,25,32,3,29,23,79,22,0,92
9243fea6,0,0,0,0,0,0,1,1,0,0,0,0,0,0,0,3
92948149,10,7,8,2,0,5,6,1,4,0,4,3,13,8,0,8
92c62328,0,0,0,0,0,0,0,0,0,0,0,1,1,3,4,12
92fffd91,1,1,1,0,0,1,2,1,2,0,2,4,5,0,0,5
936d9e3e,0,0,0,0,0,0,0,0,0,0,0,0,0,0,0,2
93a194e1,6,4,3,3,0,2,5,3,7,3,4,11,17,41,0,34
93a50d2c,9,4,4,4,1,2,5,3,2,1,1,10,19,33,0,28
93b0fa3c,9,5,5,3,1,2,13,11,2,0,2,3,12,1,0,35
93b891d1,5,4,1,3,1,0,3,3,7,3,4,2,7,2,0,13
93bf37c5,0,0,0,0,0,0,1,1,2,1,1,1,1,4,0,9
94d260aa,9,5,4,4,1,6,8,2,8,6,2,18,27,42,1,32
94f8d10c,7,6,5,2,0,5,9,4,8,7,1,8,15,89,0,68
950ff24d,1,0,1,0,0,1,1,0,0,0,0,0,1,1,1,1
951a4ee4,7,4,3,4,0,2,7,5,2,1,1,6,13,1,0,11
951f1739,0,0,0,0,0,0,6,6,3,0,3,0,0,2,0,19
958aba30,2,2,0,2,0,2,4,2,3,1,2,5,7,30,0,31
95a34045,10,7,7,3,0,4,5,1,4,4,0,17,27,43,0,25
963829d0,10,7,4,5,1,2,12,10,7,0,7,1,11,11,0,44
9674002f,8,3,2,3,3,2,6,4,3,0,3,5,13,0,0,18
96f2d977,7,5,5,2,0,2,6,4,1,0,1,1,8,1,0,16
972d595a,0,0,0,0,0,0,0,0,0,0,0,0,0,0,0,2
9731ab71,2,1,2,0,0,0,2,2,0,0,0,0,2,1,0,6
97bfa797,3,3,0,2,1,1,4,3,1,0,1,1,4,3,0,9
9804ba8b,0,0,0,0,0,0,0,0,0,0,0,0,0,0,0,0
9836e892,0,0,0,0,0,0,1,1,1,0,1,4,4,1,0,1
9866afec,11,7,3,7,1,2,10,8,4,0,4,8,19,1,0,41
98d2c2c4,34,27,12,21,1,8,21,13,14,0,14,21,55,10,1,65
98daa26a,3,1,1,2,0,0,2,2,1,0,1,1,4,5,0,4
998d5709,2,2,2,0,0,0,1,1,0,0,0,1,3,1,0,17
99a5321f,3,2,1,0,2,1,2,1,4,2,2,4,7,2,0,16
99de6b6f,2,2,1,1,0,0,2,2,1,0,1,3,5,2,0,5
9a1f2e1c,23,15,9,10,4,11,13,2,4,1,3,15,38,18,0,37
9a2e0ccc,7,6,0,6,1,1,8,7,4,0,4,2,9,3,0,13
9a34c46d,14,4,7,3,4,8,11,3,9,1,8,5,19,14,0,29
9a493fb7,11,5,6,3,2,5,8,3,5,1,4,7,18,4,0,18
9a6cfc02,3,1,1,1,1,0,0,0,3,0,3,7,10,6,0,5
9ae9eaea,16,11,12,3,1,6,10,4,6,2,4,12,28,36,0,40
9b6df52f,2,2,1,0,1,1,4,3,0,0,0,4,6,11,0,5
9c318325,4,3,1,2,1,3,7,4,11,1,10,3,7,6,0,50
9cc4ae6d,0,0,0,0,0,0,0,0,0,0,0,0,0,0,0,0
9d01ec0f,11,8,8,3,0,3,4,1,2,0,2,0,11,2,0,10
9d0f626a,0,0,0,0,0,0,0,0,0,0,0,0,0,1,1,13
9d12e142,0,0,0,0,0,0,0,0,0,0,0,0,0,6,2,5
9d1e8e76,8,6,2,5,1,4,14,10,3,0,3,10,18,4,0,32
9d1f0c99,10,5,8,2,0,5,6,1,3,1,2,6,16,10,0,13
9d4c45d6,10,7,3,6,1,0,5,5,1,0,1,3,13,1,0,19
9d971f13,11,7,1,7,3,1,15,14,7,1,6,5,16,4,0,25
9dbb75ca,4,4,0,3,1,0,6,6,4,0,4,1,5,0,0,6
9dc39955,0,0,0,0,0,0,0,0,1,0,1,0,0,0,0,3
9deab2db,6,4,4,1,1,2,3,1,2,0,2,5,11,0,1,11
9efa1d25,6,2,1,2,3,0,7,7,3,1,2,1,7,2,0,17
9f0ea33f,0,0,0,0,0,0,1,1,1,0,1,0,0,2,0,2
9f156830,3,2,3,0,0,1,4,3,1,1,0,3,6,1,0,11
9f1893b9,10,5,3,7,0,0,8,8,12,0,12,3,13,3,0,25
9f323c71,7,3,6,1,0,1,5,4,4,0,4,4,11,9,0,29
9f381d8b,6,2,1,2,3,1,2,1,1,0,1,1,7,0,0,6
9f979eb2,4,4,3,1,0,1,3,2,3,3,0,1,5,11,0,11
9f9c57f0,1,1,0,1,0,0,2,2,3,1,2,1,2,7,1,12
9fc0f253,8,5,6,2,0,6,7,1,5,1,4,7,15,31,0,30
9fc2531b,5,2,1,3,1,0,5,5,0,0,0,1,6,3,0,11
Besar-Iseni,0,0,0,0,0,0,0,0,0,0,0,0,0,0,0,0
Binyam-Belay,0,0,0,0,0,0,0,0,0,0,0,0,0,0,0,0
Filip-Stojchevski,0,0,0,0,0,0,0,0,0,0,0,0,0,0,0,0
Petr-Hronek,0,0,0,0,0,0,0,0,0,0,0,0,0,0,0,0
a0255c67,4,3,2,0,2,2,4,2,1,0,1,1,5,0,0,5
a0313275,12,7,9,1,2,3,7,4,2,0,2,4,16,8,0,28
a08b5224,1,0,1,0,0,1,1,0,1,0,1,0,1,0,0,0
a08b974a,28,21,9,15,4,9,22,13,23,0,23,12,40,18,0,63
a0c8a672,0,0,0,0,0,0,0,0,0,0,0,1,1,1,0,0
a0d59251,15,12,13,1,1,9,23,14,6,2,4,8,23,9,0,34
a1216563,14,7,5,5,4,3,12,9,10,1,9,7,21,6,0,40
a1474d8e,0,0,0,0,0,0,1,1,3,0,3,0,0,0,0,2
a190d597,1,0,0,0,1,1,3,2,1,0,1,1,2,2,0,10
a19be070,3,1,0,0,3,0,2,2,3,0,3,0,3,0,0,7
a1a9ef78,6,4,6,0,0,3,3,0,8,6,2,5,11,40,0,13
a2560346,0,0,0,0,0,0,0,0,0,0,0,0,0,0,0,0
a26c1727,8,3,5,1,2,0,4,4,5,0,5,2,10,1,0,16
a2f2d806,1,1,0,1,0,0,0,0,1,0,1,2,3,8,0,8
a33a0dc0,4,3,0,4,0,0,1,1,3,0,3,1,5,2,0,14
a3b03921,11,10,7,3,1,3,6,3,8,1,7,4,15,0,0,20
a3b0ed18,0,0,0,0,0,0,0,0,0,0,0,0,0,1,1,5
a3bf2258,4,3,1,2,1,2,5,3,1,0,1,0,4,0,0,3
a3ddb1b9,4,3,1,3,0,4,8,4,0,0,0,2,6,1,0,7
a44f7c60,7,6,3,3,1,4,10,6,3,1,2,4,11,4,0,13
a47e7ecd,6,3,4,2,0,5,9,4,6,3,3,5,11,34,0,22
a498e276,5,3,5,0,0,3,3,0,4,3,1,6,11,14,1,23
a49fd565,5,4,3,1,1,3,5,2,4,1,3,10,15,18,0,16
a4bd9edd,0,0,0,0,0,0,0,0,0,0,0,0,0,0,0,2
a4effc55,4,2,0,3,1,2,3,1,2,2,0,3,7,8,0,9
a4fe8cda,6,2,2,2,2,1,11,10,5,1,4,2,8,3,0,15
a5296e55,0,0,0,0,0,0,3,3,1,0,1,1,1,1,0,7
a53649b7,0,0,0,0,0,0,0,0,0,0,0,0,0,0,0,1
a565da59,0,0,0,0,0,0,0,0,0,0,0,0,0,3,1,6
a5d101a9,11,9,6,5,0,0,14,14,16,5,11,22,33,18,0,48
a5db0bec,11,9,3,7,1,2,13,11,7,3,4,3,14,14,0,34
a62c16d0,12,5,3,6,3,3,10,7,7,0,7,1,13,7,0,13
a63a995f,6,3,3,3,0,3,7,4,3,1,2,9,15,8,0,31
a6951bf8,10,8,4,6,0,1,5,4,3,1,2,11,21,0,0,40
a6de370d,13,6,5,2,6,3,5,2,11,0,11,3,16,0,0,30
a7121625,0,0,0,0,0,0,0,0,0,0,0,0,0,1,0,0
a78147dd,8,6,5,3,0,2,8,6,4,1,3,8,16,3,0,25
a78ff07f,2,2,1,1,0,1,3,2,1,0,1,2,4,0,0,8
a81ed730,14,8,4,9,1,5,18,13,5,1,4,7,21,4,0,33
a81f4896,9,7,6,2,1,6,9,3,5,4,1,4,13,26,0,30
a8327abd,13,8,6,6,1,5,10,5,4,1,3,7,20,1,0,35
a898d91e,2,1,1,1,0,0,0,0,2,1,1,1,3,1,0,6
a8a874f1,25,17,11,8,6,5,13,8,4,0,4,11,36,5,1,42
a8c0acb7,5,4,4,1,0,3,3,0,2,0,2,1,6,12,0,4
a9440c25,2,2,2,0,0,0,3,3,3,1,2,3,5,5,0,27
a96e5dc0,3,2,1,1,1,1,4,3,1,0,1,4,7,6,1,12
a97afc61,2,1,2,0,0,1,6,5,2,1,1,5,7,7,0,5
a9a3b55d,0,0,0,0,0,0,0,0,0,0,0,1,1,0,0,8
a9aa0d1d,18,12,7,10,1,3,13,10,7,3,4,3,21,3,0,74
a9e68c94,6,5,2,3,1,2,11,9,1,0,1,3,9,0,0,21
aa51343f,2,1,0,2,0,0,2,2,2,1,1,0,2,0,0,13
aa8e289e,7,3,1,3,3,2,12,10,9,0,9,6,13,6,0,25
aa954c2b,1,1,0,1,0,0,0,0,0,0,0,0,1,0,0,1
aacdfe88,29,20,20,8,1,24,30,6,8,3,5,15,44,27,0,38
aad48be9,3,1,2,1,0,1,1,0,3,1,2,2,5,14,0,15
aad4f74f,0,0,0,0,0,0,0,0,0,0,0,0,0,0,0,12
aad56ca3,0,0,0,0,0,0,0,0,0,0,0,0,0,0,0,0
aad9c3f3,5,3,1,2,2,1,4,3,3,0,3,0,5,0,0,8
aae44006,1,0,0,0,1,1,1,0,0,0,0,0,1,0,0,0
aaee68f1,0,0,0,0,0,0,0,0,2,0,2,1,1,0,0,3
ab6928f2,0,0,0,0,0,0,0,0,2,1,1,3,3,2,0,6
ab700320,6,5,1,4,1,2,6,4,7,1,6,3,9,2,0,19
abb42ce6,6,4,2,4,0,3,8,5,0,0,0,8,14,5,0,21
abcfaa50,1,1,1,0,0,1,2,1,1,0,1,0,1,0,0,4
ac7e640b,15,9,8,7,0,6,11,5,11,5,6,21,36,26,0,42
ad10eae0,11,8,4,7,0,6,12,6,1,0,1,10,21,18,0,31
ad178594,1,1,1,0,0,1,2,1,2,2,0,5,6,5,0,17
ad625c12,2,0,1,0,1,1,1,0,1,0,1,0,2,0,0,13
ae0f7da7,2,2,1,1,0,0,4,4,3,0,3,3,5,1,0,40
ae3e6d85,5,3,2,3,0,1,6,5,7,1,6,3,8,3,0,13
aec6b711,0,0,0,0,0,0,1,1,1,0,1,1,1,0,0,11
aeee3365,1,1,1,0,0,0,0,0,0,0,0,0,1,2,0,9
af03f0b9,5,3,1,4,0,1,5,4,3,0,3,0,5,0,0,5
af50141d,5,2,2,2,1,2,8,6,2,0,2,4,9,2,0,51
af8cabe1,2,1,1,0,1,1,2,1,1,0,1,3,5,4,0,2
af8e4246,6,4,2,4,0,0,4,4,0,0,0,2,8,0,0,5
af97a8af,6,4,2,4,0,0,3,3,2,0,2,0,6,3,1,14
afda7d82,11,9,3,6,2,1,10,9,6,1,5,8,19,3,0,32
b01e6102,7,4,4,3,0,4,8,4,3,1,2,5,12,16,0,20
b037bd4f,4,2,1,2,1,0,7,7,3,0,3,5,9,0,0,27
b073f5ea,3,3,1,2,0,1,3,2,6,5,1,7,10,13,0,11
b0fce72c,3,2,0,2,1,1,3,2,1,0,1,1,4,3,0,13
b1062a37,8,4,7,1,0,4,8,4,13,10,3,16,24,51,0,27
b12c68bf,18,12,7,7,4,5,21,16,12,2,10,15,33,17,0,42
b15e93aa,8,8,4,4,0,0,3,3,4,0,4,3,11,1,0,25
b175c21c,1,0,1,0,0,0,4,4,3,0,3,5,6,4,0,28
b18095b6,3,2,2,1,0,0,1,1,1,1,0,2,5,8,0,15
b182a240,3,3,1,2,0,1,2,1,0,0,0,1,4,0,0,13
b1deecf8,6,5,6,0,0,0,0,0,2,1,1,3,9,13,0,37
b20eece9,1,0,1,0,0,1,2,1,1,0,1,0,1,4,0,5
b20f5a66,2,1,2,0,0,0,3,3,4,2,2,5,7,11,0,7
b2484b77,4,3,1,2,1,3,4,1,3,0,3,3,7,2,0,3
b2bee28a,0,0,0,0,0,0,1,1,2,0,2,1,1,0,0,9
b2db927b,4,3,3,1,0,1,4,3,0,0,0,4,8,5,0,18
b2ec3323,8,5,2,5,1,1,6,5,8,1,7,3,11,0,0,33
b2f1fbd5,10,7,6,3,1,3,8,5,13,4,9,10,20,32,2,30
b340a30a,0,0,0,0,0,0,2,2,2,0,2,1,1,3,0,8
b3aed40d,19,17,13,5,1,15,22,7,9,5,4,5,24,29,0,38
b3b310f0,2,1,2,0,0,1,2,1,1,0,1,0,2,3,0,2
b3dc6eca,6,6,2,4,0,4,5,1,8,3,5,13,19,26,0,28
b418dbd4,21,13,8,11,2,8,19,11,7,0,7,3,24,9,0,33
b437b9bd,1,1,1,0,0,1,1,0,0,0,0,1,2,0,0,1
b4541446,2,2,2,0,0,1,3,2,2,0,2,1,3,1,0,5
b45e185a,6,5,3,3,0,2,4,2,3,0,3,3,9,1,0,20
b48215cd,5,4,3,2,0,1,7,6,8,0,8,5,10,3,0,14
b4825073,7,6,5,2,0,4,9,5,3,0,3,7,14,10,0,46
b54ea609,5,4,4,1,0,3,5,2,2,1,1,11,16,11,0,9
b583aef5,0,0,0,0,0,0,0,0,0,0,0,0,0,3,0,4
b58b3e7b,0,0,0,0,0,0,0,0,0,0,0,0,0,0,0,0
b5920350,0,0,0,0,0,0,2,2,1,0,1,0,0,1,0,6
b5b2e1ba,5,2,0,4,1,1,1,0,0,0,0,1,6,0,0,6
b653b65b,5,2,2,3,0,0,2,2,0,0,0,3,8,0,0,13
b682dcf6,16,8,12,4,0,9,12,3,8,4,4,4,20,20,1,29
b686f4c0,8,7,3,4,1,5,9,4,6,0,6,2,10,4,0,22
b6a6e0a7,9,8,6,3,0,7,13,6,4,0,4,5,14,5,0,16
b6b2b820,2,2,0,1,1,0,3,3,1,0,1,1,3,1,0,3
b7084daf,3,1,0,2,1,1,4,3,1,0,1,0,3,1,1,12
b70be510,8,8,6,1,1,6,9,3,7,6,1,11,19,33,0,30
b746d309,4,3,3,1,0,1,4,3,3,2,1,6,10,6,0,19
b75af9ce,4,2,2,1,1,1,6,5,2,0,2,5,9,0,0,8
b7d8cbb9,0,0,0,0,0,0,1,1,0,0,0,1,1,0,0,3
b7e1c3b5,1,0,0,1,0,0,1,1,0,0,0,1,2,1,0,6
b7f2edff,6,5,2,3,1,2,2,0,2,1,1,2,8,6,0,13
b825a650,2,2,2,0,0,2,8,6,3,2,1,9,11,4,1,28
b8814868,17,10,7,10,0,3,13,10,11,0,11,12,29,7,0,44
b8ae831b,19,15,15,4,0,13,19,6,2,2,0,18,37,38,0,36
b8fb9e84,5,2,0,5,0,0,0,0,0,0,0,0,5,1,0,3
b9177a6f,4,2,1,2,1,2,4,2,9,0,9,1,5,1,0,20
b93b7882,0,0,0,0,0,0,1,1,1,0,1,0,0,2,0,5
b9747ada,0,0,0,0,0,0,1,1,3,0,3,1,1,1,0,12
b9c19ad9,1,0,1,0,0,0,1,1,0,0,0,2,3,2,0,6
ba6e52b0,4,1,2,2,0,1,6,5,2,1,1,11,15,23,0,17
ba7673a6,1,0,0,1,0,0,0,0,1,0,1,0,1,0,0,2
ba998e22,4,3,2,2,0,1,3,2,2,1,1,8,12,28,0,20
bafcf742,25,16,16,9,0,15,23,8,11,6,5,12,37,28,0,39
bb19da7c,2,1,0,1,1,1,5,4,1,0,1,1,3,0,0,10
bb25c778,0,0,0,0,0,0,0,0,0,0,0,0,0,3,0,10
bb31def4,0,0,0,0,0,0,0,0,0,0,0,0,0,0,0,0
bb6ab7af,4,2,3,1,0,2,3,1,0,0,0,2,6,1,0,4
bba30585,9,6,6,3,0,8,14,6,3,2,1,14,23,25,0,38
bbddc31f,2,2,1,1,0,0,1,1,1,0,1,2,4,3,0,5
bc5b5be5,3,1,0,2,1,0,3,3,0,0,0,0,3,0,0,10
bc6bd723,2,2,0,2,0,1,5,4,0,0,0,1,3,2,0,17
bcb2ccd8,0,0,0,0,0,0,0,0,0,0,0,0,0,1,0,12
bcd1bea2,5,4,3,2,0,1,5,4,5,2,3,1,6,3,0,21
bcd9b19c,18,14,8,9,1,7,11,4,3,0,3,13,31,14,0,32
bdf7b97d,4,2,3,1,0,2,7,5,0,0,0,0,4,3,0,8
be170419,6,6,5,1,0,2,3,1,4,2,2,5,11,11,0,14
be42a291,8,6,2,3,3,1,15,14,3,0,3,1,9,0,0,36
be6cd760,1,0,0,1,0,0,0,0,3,3,0,1,2,6,0,5
beb391dd,8,3,6,2,0,1,7,6,1,0,1,1,9,3,0,26
beb6c168,9,7,3,6,0,2,7,5,8,2,6,7,16,14,0,38
bece776f,11,5,3,6,2,3,11,8,7,0,7,1,12,0,0,33
beec76cc,5,3,0,3,2,1,6,5,2,2,0,2,7,6,0,18
bef09ca8,8,5,7,1,0,5,9,4,7,3,4,3,11,10,1,12
bf309d24,6,3,0,2,4,2,4,2,0,0,0,1,7,2,0,16
bf5fc4fc,2,1,2,0,0,0,3,3,1,0,1,1,3,1,0,17
bfc5768b,21,15,7,11,3,8,24,16,9,1,8,13,34,16,0,42
bfe272bd,1,1,1,0,0,0,0,0,2,2,0,1,2,0,0,4
c01c66d9,9,6,6,3,0,5,8,3,6,3,3,11,20,9,0,28
c0321811,28,23,14,13,1,14,20,6,12,1,11,17,45,17,0,52
c05dfb74,2,2,0,2,0,0,0,0,2,0,2,1,3,0,0,11
c089980e,0,0,0,0,0,0,1,1,1,0,1,1,1,4,0,5
c0b1a6da,0,0,0,0,0,0,0,0,0,0,0,0,0,0,0,0
c1268aa3,7,5,7,0,0,3,4,1,12,9,3,18,25,51,1,30
c14bc029,26,18,12,10,4,4,28,24,13,3,10,18,44,14,0,55
c18d22f5,9,8,7,1,1,4,7,3,6,1,5,6,15,6,0,20
c18f2143,16,10,13,2,1,8,11,3,4,3,1,21,37,32,0,41
c1a13650,1,1,0,0,1,0,0,0,1,0,1,0,1,3,0,7
c1b7847c,20,16,13,7,0,7,17,10,5,1,4,10,30,10,1,24
c2009df3,1,1,0,1,0,0,0,0,0,0,0,0,1,0,0,2
c2304da8,19,12,10,8,1,3,5,2,6,2,4,18,37,21,2,49
c2e41cfb,0,0,0,0,0,0,0,0,0,0,0,0,0,1,0,3
c3ee18ef,21,16,15,5,1,15,25,10,9,3,6,2,23,20,0,37
c3fd9887,1,1,0,1,0,0,1,1,1,0,1,0,1,3,0,2
c41ca3d8,1,0,0,1,0,0,0,0,1,0,1,0,1,3,0,6
c43a8301,6,4,2,3,1,2,4,2,3,2,1,3,9,15,0,14
c43e5e7e,7,4,2,4,1,1,8,7,9,2,7,1,8,6,0,34
c44a1d58,19,9,11,8,0,13,27,14,7,2,5,12,31,4,0,65
c47541e0,14,11,10,4,0,2,6,4,3,0,3,8,22,7,0,32
c48130b7,1,1,1,0,0,0,1,1,0,0,0,0,1,0,1,3
c49afee6,2,2,0,2,0,0,0,0,0,0,0,0,2,0,0,3
c4a306a1,15,10,11,3,1,3,6,3,6,5,1,11,26,31,0,33
c4af5889,3,0,1,1,1,0,0,0,0,0,0,2,5,0,0,5
c56dc39e,7,4,3,2,2,3,8,5,3,3,0,10,17,22,1,28
c5b7c315,3,2,2,1,0,0,5,5,3,2,1,1,4,15,0,14
c5bdb6e3,6,3,3,1,2,2,6,4,7,3,4,8,14,6,0,26
c5ea2dab,3,2,3,0,0,3,3,0,5,1,4,6,9,13,1,21
c5eaff5c,0,0,0,0,0,0,0,0,1,0,1,1,1,0,0,1
c5fd13e9,2,1,1,1,0,0,3,3,5,2,3,3,5,7,0,24
c6500a29,1,1,0,1,0,0,4,4,0,0,0,0,1,2,0,6
c67b8590,2,1,1,1,0,1,3,2,0,0,0,1,3,1,0,5
c693347d,0,0,0,0,0,0,0,0,0,0,0,0,0,0,0,1
c699e60c,1,1,0,0,1,0,1,1,1,0,1,1,2,0,0,15
c6ac6579,0,0,0,0,0,0,1,1,1,0,1,1,1,2,0,5
c6f99e42,11,7,7,4,0,6,10,4,5,2,3,11,22,38,1,22
c71e97ba,6,4,3,1,2,0,7,7,2,1,1,1,7,1,0,18
c76153e5,14,11,11,3,0,5,13,8,5,2,3,11,25,21,0,30
c7e0f364,6,2,1,3,2,2,6,4,3,0,3,2,8,9,0,17
c7f24d4b,1,0,0,0,1,0,0,0,0,0,0,2,3,2,0,7
c84c1afc,0,0,0,0,0,0,0,0,0,0,0,0,0,1,0,2
c886b062,6,4,3,1,2,1,6,5,3,0,3,1,7,8,0,19
c904f3d5,0,0,0,0,0,0,0,0,0,0,0,1,1,5,1,5
c90b2e8f,2,1,1,1,0,1,1,0,2,2,0,3,5,12,0,8
c98971d1,2,2,1,1,0,0,1,1,0,0,0,1,3,4,0,4
c9e5f0f6,1,0,0,1,0,0,1,1,2,0,2,0,1,0,0,8
ca45605e,0,0,0,0,0,0,0,0,1,0,1,0,0,0,0,1
ca8033cb,6,5,3,3,0,3,5,2,3,1,2,6,12,19,0,22
ca9178af,15,9,8,7,0,6,13,7,9,2,7,6,21,7,0,30
cb85d8d0,6,5,6,0,0,2,10,8,5,4,1,11,17,26,0,38
cbd92a70,1,0,1,0,0,0,0,0,0,0,0,0,1,1,0,3
cbdf7d5c,0,0,0,0,0,0,1,1,0,0,0,0,0,0,0,4
cbec1196,3,3,1,1,1,0,4,4,3,0,3,4,7,7,0,25
cc3477f4,0,0,0,0,0,0,0,0,0,0,0,0,0,0,0,5
cc700722,5,3,2,3,0,1,4,3,1,0,1,2,7,0,0,13
cc77354e,25,11,14,11,0,6,22,16,6,3,3,16,41,20,0,26
cc89c822,0,0,0,0,0,0,0,0,0,0,0,0,0,0,0,3
cc96d422,14,10,7,4,3,5,15,10,9,2,7,9,23,6,1,21
ccc520dc,11,10,7,2,2,5,11,6,5,1,4,6,17,2,0,30
ccc66d00,19,12,9,7,3,14,27,13,17,4,13,6,25,8,0,33
cd0ecf81,9,3,5,3,1,2,4,2,2,0,2,3,12,1,0,20
cd0fa27b,11,8,1,7,3,3,14,11,9,0,9,3,14,3,0,33
cd59b9df,0,0,0,0,0,0,0,0,0,0,0,0,0,0,0,0
cda08080,6,4,5,1,0,3,8,5,8,3,5,11,17,22,0,26
cda0b317,0,0,0,0,0,0,0,0,0,0,0,0,0,2,0,1
cdf65d12,3,3,2,1,0,1,2,1,1,0,1,3,6,1,0,5
ce5143da,11,8,2,7,2,2,12,10,11,2,9,5,16,14,0,32
ce538b0b,5,5,3,2,0,0,1,1,1,0,1,1,6,5,0,8
ce6480b1,11,6,5,3,3,4,9,5,6,0,6,10,21,4,0,25
ce940592,8,5,1,6,1,6,7,1,8,4,4,9,17,13,0,26
cea0df32,3,2,1,2,0,1,4,3,3,1,2,1,4,3,0,9
ceb30355,6,4,5,1,0,3,6,3,4,3,1,7,13,23,0,24
cf41510e,2,1,2,0,0,1,3,2,4,2,2,6,8,12,0,7
cf8ef0a1,6,2,1,3,2,4,8,4,4,0,4,3,9,5,0,26
cfa65a2e,9,7,4,5,0,1,2,1,1,1,0,0,9,1,0,8
cfd8d664,16,12,7,9,0,8,13,5,8,1,7,8,24,13,0,33
cff7dcb0,0,0,0,0,0,0,2,2,2,0,2,1,1,3,0,4
d0042ab9,3,2,3,0,0,2,6,4,5,0,5,8,11,12,0,17
d02e0cab,10,5,4,5,1,3,20,17,14,3,11,13,23,12,0,57
d045ccb2,0,0,0,0,0,0,0,0,0,0,0,0,0,0,0,2
d054d8b0,5,2,0,3,2,0,2,2,1,0,1,2,7,4,0,23
d071af92,10,8,5,5,0,1,5,4,8,0,8,13,23,0,0,63
d0a01d27,13,9,6,6,1,5,7,2,1,0,1,3,16,5,0,16
d0c41b99,0,0,0,0,0,0,0,0,0,0,0,1,1,7,1,3
d0d8dd44,9,8,6,3,0,6,7,1,10,6,4,10,19,21,0,35
d0e6399c,0,0,0,0,0,0,0,0,1,0,1,0,0,1,0,0
d13aea07,15,9,8,4,3,9,20,11,2,1,1,10,25,14,0,7
d189e48f,1,1,0,0,1,0,0,0,0,0,0,0,1,3,0,0
d1992a3b,4,2,3,1,0,4,8,4,4,0,4,6,10,26,0,15
d2110326,4,3,2,1,1,2,4,2,7,5,2,11,15,28,0,23
d2416c2e,1,1,1,0,0,1,5,4,4,0,4,3,4,1,0,8
d248cd8f,10,4,5,5,0,5,9,4,3,1,2,3,13,41,1,34
d2800f47,9,5,3,6,0,2,4,2,4,1,3,8,17,5,0,15
d2aea9ac,0,0,0,0,0,0,2,2,0,0,0,0,0,0,0,0
d2ba04be,0,0,0,0,0,0,0,0,0,0,0,1,1,0,0,0
d2ee6d5b,3,2,2,1,0,2,6,4,1,0,1,1,4,0,0,9
d3149135,0,0,0,0,0,0,0,0,0,0,0,0,0,3,0,5
d31c4115,1,0,0,1,0,0,4,4,2,0,2,4,5,6,0,7
d38174c3,0,0,0,0,0,0,0,0,1,1,0,0,0,0,0,3
d40cff47,0,0,0,0,0,0,2,2,0,0,0,0,0,0,0,0
d4535821,7,2,5,2,0,5,7,2,1,0,1,1,8,8,0,17
d46ce637,2,2,1,0,1,1,2,1,2,0,2,1,3,2,0,5
d4931a5a,2,2,1,1,0,0,1,1,0,0,0,1,3,0,0,6
d4aa40b8,3,2,3,0,0,0,2,2,1,0,1,2,5,3,0,15
d4cb83cc,11,6,4,6,1,3,11,8,8,2,6,8,19,13,1,34
d4e7c451,2,2,1,1,0,1,3,2,8,1,7,3,5,3,0,19
d4e93bab,16,12,5,10,1,6,15,9,7,2,5,8,24,6,0,42
d4f8f243,5,3,3,1,1,0,4,4,1,0,1,1,6,3,0,18
d552c4a1,6,4,3,2,1,1,1,0,2,0,2,4,10,4,0,16
d5575935,42,33,12,25,5,11,45,34,24,2,22,20,62,14,0,95
d56b9362,12,8,6,6,0,3,8,5,2,1,1,7,19,9,0,26
d5ce52a5,0,0,0,0,0,0,0,0,1,0,1,0,0,0,0,0
d60ffe68,1,0,0,0,1,0,0,0,1,0,1,1,2,0,0,4
d61b3354,3,2,1,2,0,1,1,0,0,0,0,4,7,1,0,12
d637fc22,12,9,3,6,3,6,13,7,4,0,4,4,16,12,0,20
d63e2912,24,18,13,9,2,8,15,7,9,6,3,20,44,39,0,57
d659a854,2,1,0,2,0,0,0,0,0,0,0,0,2,0,0,0
d732f72c,2,1,1,1,0,1,1,0,3,0,3,0,2,3,0,4
d7398ac3,8,6,3,4,1,4,8,4,3,0,3,1,9,6,0,15
d757fd45,7,4,4,3,0,2,4,2,5,1,4,3,10,5,0,12
d79a8c87,11,6,7,3,1,4,7,3,6,3,3,12,23,17,0,51
d7a70e5e,14,12,6,6,2,5,6,1,4,2,2,3,17,5,0,26
d7c09951,1,0,1,0,0,0,0,0,0,0,0,1,2,2,0,1
d820a7c8,3,3,1,2,0,1,4,3,3,0,3,3,6,1,0,16
d849ef0f,13,7,8,5,0,4,11,7,8,3,5,8,21,17,0,40
d87e2cae,1,0,0,1,0,0,2,2,0,0,0,0,1,4,0,7
d8ff3b2c,1,1,1,0,0,1,2,1,0,0,0,3,4,1,0,11
d9847696,1,1,0,1,0,0,0,0,3,1,2,0,1,0,0,9
d995ed27,4,4,0,4,0,1,2,1,3,0,3,6,10,3,0,26
d9bda115,5,2,0,4,1,1,5,4,5,0,5,10,15,2,0,30
da1185fc,5,5,3,1,1,3,4,1,3,0,3,4,9,1,0,10
da1c9094,0,0,0,0,0,0,0,0,0,0,0,0,0,0,0,0
da270297,1,1,0,1,0,1,2,1,0,0,0,0,1,2,0,5
da4bd8fb,0,0,0,0,0,0,0,0,0,0,0,0,0,2,0,0
da617483,20,13,15,5,0,14,15,1,17,14,3,17,37,49,1,49
da6cb94b,13,8,5,7,1,7,9,2,5,3,2,10,23,31,0,25
da974c7b,4,4,2,2,0,2,2,0,5,4,1,3,7,2,0,9
dab0da1c,3,2,2,1,0,1,2,1,0,0,0,0,3,1,0,4
dab75831,1,0,0,0,1,0,0,0,0,0,0,0,1,0,0,1
dabec4c3,6,5,4,2,0,2,5,3,17,7,10,9,15,57,0,30
db4ed67b,11,8,4,6,1,6,9,3,4,0,4,3,14,2,0,31
db7161ed,2,2,1,0,1,1,1,0,0,0,0,0,2,0,0,3
db750822,5,4,4,1,0,1,17,16,3,0,3,2,7,3,0,15
dc3fa3b5,14,8,3,10,1,2,11,9,8,2,6,6,20,8,0,37
dc4511f3,0,0,0,0,0,0,0,0,0,0,0,0,0,0,0,0
dc4f62fd,8,3,3,4,1,2,9,7,6,1,5,4,12,2,0,13
dc52c72f,22,17,12,7,3,9,15,6,7,3,4,17,39,41,0,31
dc62fbee,12,10,4,6,2,2,4,2,0,0,0,5,17,1,0,13
dc6f5bdd,8,6,7,1,0,3,9,6,8,6,2,13,21,30,4,46
dc8f5b58,3,2,3,0,0,1,1,0,3,1,2,1,4,7,0,13
dc90cfbe,1,0,0,1,0,0,2,2,0,0,0,0,1,5,0,4
dcd160e4,5,5,2,3,0,1,3,2,3,0,3,0,5,9,1,26
dd08d93a,2,1,0,2,0,1,2,1,1,0,1,2,4,1,0,1
dd0daf32,11,7,4,2,5,3,13,10,6,0,6,2,13,4,0,27
dd2044f4,4,4,3,1,0,1,1,0,3,0,3,4,8,9,0,9
de0282f9,4,2,3,1,0,2,3,1,3,0,3,1,5,7,0,17
de39485a,1,0,1,0,0,1,1,0,0,0,0,0,1,0,0,1
dead55e5,11,8,3,6,2,3,5,2,3,1,2,5,16,1,0,30
debc6b55,2,1,1,1,0,0,2,2,1,0,1,0,2,1,0,4
dee86451,7,7,3,4,0,3,3,0,2,2,0,2,9,2,0,16
def69cd0,12,7,6,4,2,1,7,6,3,0,3,5,17,8,0,29
df525574,11,9,4,6,1,4,10,6,7,0,7,7,18,20,0,58
df69b544,10,6,1,6,3,3,17,14,8,1,7,8,18,1,0,54
df85d472,1,1,0,1,0,0,0,0,0,0,0,1,2,1,0,7
dff153a4,16,10,6,9,1,8,20,12,8,3,5,13,29,14,0,38
e0314d87,19,11,12,7,0,8,17,9,7,2,5,12,31,36,0,50
e0a1c004,6,5,4,2,0,3,13,10,8,2,6,5,11,12,0,38
e0cd04e0,1,1,0,1,0,0,0,0,0,0,0,0,1,0,0,3
e12d7851,4,4,2,2,0,1,2,1,0,0,0,1,5,5,0,13
e14ec482,0,0,0,0,0,0,0,0,0,0,0,1,1,1,0,2
e16dd48e,3,0,3,0,0,2,2,0,3,0,3,3,6,5,0,8
e1bbb68d,2,2,0,1,1,0,1,1,0,0,0,1,3,1,0,13
e248e62f,2,1,2,0,0,1,1,0,2,0,2,0,2,1,0,5
e280527c,10,9,1,7,2,4,15,11,3,0,3,3,13,2,0,12
e2a302a8,10,7,5,5,0,3,5,2,8,1,7,4,14,2,0,14
e2bf2abc,2,1,1,1,0,0,2,2,0,0,0,5,7,1,0,2
e3207d47,0,0,0,0,0,0,0,0,0,0,0,0,0,0,0,0
e32721e6,0,0,0,0,0,0,0,0,0,0,0,0,0,0,0,0
e358587b,0,0,0,0,0,0,0,0,0,0,0,1,1,2,0,8
e373f1ec,5,3,0,4,1,3,4,1,2,1,1,7,12,2,0,22
e3993b65,8,6,4,3,1,6,13,7,6,0,6,6,14,2,0,49
e3a5814e,20,14,8,8,4,5,9,4,10,1,9,14,34,16,0,65
e3d0b0c4,5,3,4,1,0,3,4,1,7,3,4,23,28,70,2,55
e41ee432,2,2,1,1,0,2,4,2,8,6,2,9,11,23,0,29
e4738e91,3,2,0,3,0,2,6,4,3,2,1,5,8,6,0,5
e4a26a91,7,3,2,5,0,5,8,3,6,2,4,7,14,7,0,22
e4ed2628,9,7,5,4,0,4,6,2,1,0,1,4,13,4,0,10
e4fcb211,4,2,0,4,0,2,5,3,0,0,0,1,5,2,0,12
e599253a,0,0,0,0,0,0,2,2,0,0,0,0,0,0,0,3
e61b8aee,8,7,4,2,2,3,8,5,10,5,5,7,15,19,0,45
e61c6efb,4,4,3,1,0,1,8,7,5,2,3,7,11,17,0,12
e66a1ad7,0,0,0,0,0,0,0,0,0,0,0,0,0,4,0,1
e6ad16b2,2,1,0,2,0,1,1,0,1,0,1,1,3,1,0,7
e704919e,0,0,0,0,0,0,0,0,0,0,0,0,0,0,1,1
e73659d3,1,1,1,0,0,0,1,1,1,0,1,0,1,5,0,8
e7986081,1,1,0,0,1,1,2,1,1,0,1,0,1,5,0,6
e7ee38c3,0,0,0,0,0,0,0,0,0,0,0,1,1,2,0,9
e814316b,0,0,0,0,0,0,0,0,0,0,0,0,0,0,0,0
e81f0356,2,2,1,1,0,1,2,1,0,0,0,3,5,9,0,5
e8ce5a3e,0,0,0,0,0,0,0,0,0,0,0,0,0,0,0,1
e8d0a3a1,0,0,0,0,0,0,0,0,0,0,0,0,0,0,0,1
e94d79e3,0,0,0,0,0,0,0,0,0,0,0,4,4,2,0,10
e961d3ac,0,0,0,0,0,0,0,0,0,0,0,0,0,1,0,9
e97150c0,10,9,7,3,0,6,8,2,5,4,1,19,29,17,0,33
e978d6b6,0,0,0,0,0,0,0,0,0,0,0,0,0,0,0,0
ea07ceb3,4,4,1,2,1,1,2,1,1,0,1,2,6,0,0,11
ea0ff634,7,3,1,6,0,0,5,5,4,0,4,2,9,4,0,19
ea490705,4,4,0,2,2,2,3,1,2,0,2,1,5,1,0,7
ea6a7ab4,8,7,2,5,1,2,2,0,4,0,4,2,10,0,0,7
ea7a8366,15,11,7,7,1,6,12,6,9,1,8,5,20,4,0,30
eac044ad,19,13,5,8,6,7,19,12,11,0,11,9,28,13,0,69
ead960f2,8,7,2,4,2,3,8,5,6,0,6,4,12,2,0,28
eafac393,9,2,6,3,0,9,13,4,10,5,5,9,18,23,0,36
eb174a27,3,1,2,1,0,0,0,0,1,1,0,3,6,10,0,7
eb2b33aa,0,0,0,0,0,0,0,0,0,0,0,0,0,0,0,0
eb3f56e5,2,2,2,0,0,1,1,0,4,2,2,4,6,7,0,8
eb5bc3eb,4,3,3,1,0,2,3,1,1,0,1,1,5,5,0,9
eb87ec70,1,1,0,1,0,0,0,0,1,1,0,0,1,0,0,5
ebc29a56,2,1,1,1,0,1,6,5,2,0,2,0,2,3,0,4
ebc49727,1,1,0,1,0,0,0,0,0,0,0,1,2,1,0,6
ecab64a0,7,3,2,5,0,5,9,4,2,0,2,3,10,3,0,10
ecbb3fdf,10,5,5,4,1,6,10,4,1,0,1,6,16,3,1,20
ecf151ac,2,0,0,2,0,0,0,0,0,0,0,1,3,0,0,3
ed16934e,2,0,0,1,1,1,4,3,0,0,0,0,2,0,0,6
ed2b33cb,8,5,7,1,0,4,8,4,0,0,0,4,12,6,0,8
ed560575,16,11,6,6,4,7,12,5,8,1,7,16,32,17,0,49
ed5886d2,17,10,7,10,0,5,13,8,24,4,20,4,21,12,0,35
ed60d19f,3,2,2,1,0,2,3,1,4,0,4,3,6,2,0,16
ed90babd,1,1,0,1,0,0,2,2,1,0,1,1,2,0,0,4
ed99d19e,0,0,0,0,0,0,0,0,1,0,1,0,0,0,0,0
eddcbbc4,7,6,7,0,0,4,8,4,7,1,6,4,11,5,0,24
ee833569,0,0,0,0,0,0,0,0,0,0,0,1,1,1,1,11
ee8508c0,0,0,0,0,0,0,0,0,0,0,0,0,0,1,0,8
ef3909cd,2,1,2,0,0,1,1,0,1,0,1,0,2,6,0,11
ef4249ff,3,3,2,1,0,3,3,0,2,0,2,4,7,1,1,17
ef5b337e,5,1,1,4,0,2,8,6,7,1,6,11,16,12,0,33
ef619b0b,13,8,6,5,2,4,10,6,3,1,2,11,24,3,0,44
ef8cafeb,1,1,0,1,0,1,3,2,4,4,0,4,5,13,0,10
ef8f266e,0,0,0,0,0,0,2,2,1,0,1,0,0,0,0,2
efc33b33,0,0,0,0,0,0,0,0,1,1,0,1,1,11,0,4
efe679a0,14,7,7,6,1,8,14,6,5,1,4,19,33,28,1,44
f00de885,0,0,0,0,0,0,0,0,0,0,0,0,0,4,2,5
f04f45a2,2,1,1,1,0,1,1,0,0,0,0,1,3,0,0,2
f07be45a,4,4,1,2,1,1,4,3,2,1,1,3,7,5,0,9
f08a8947,12,7,8,4,0,6,7,1,10,9,1,11,23,32,0,36
f0da930c,9,7,8,1,0,3,6,3,10,7,3,15,24,38,0,41
f0e3b343,0,0,0,0,0,0,2,2,1,1,0,2,2,4,0,12
f0faccb9,0,0,0,0,0,0,0,0,0,0,0,0,0,0,0,0
f0fc9d0e,1,0,0,1,0,0,2,2,4,1,3,0,1,4,0,13
f15b778f,20,15,8,12,0,5,10,5,0,0,0,8,28,7,0,38
f1b17a24,12,6,4,7,1,4,8,4,8,1,7,6,18,10,0,34
f1bed920,2,2,1,1,0,0,1,1,2,0,2,2,4,2,0,10
f24ea523,3,2,0,3,0,0,5,5,5,0,5,2,5,1,0,5
f25c8e3a,11,7,0,8,3,4,7,3,6,1,5,7,18,3,0,53
f2d063ec,22,12,13,6,3,9,24,15,8,1,7,9,31,6,0,86
f2e3b81c,1,1,0,1,0,0,1,1,1,0,1,0,1,0,0,5
f2eaebe9,9,7,4,3,2,4,9,5,0,0,0,2,11,2,0,28
f30a4ab1,7,5,0,5,2,2,4,2,1,0,1,3,10,1,0,26
f33238db,0,0,0,0,0,0,0,0,0,0,0,0,0,0,0,0
f346787e,1,1,0,1,0,1,2,1,1,1,0,1,2,0,0,4
f373db50,12,6,9,3,0,3,9,6,6,1,5,6,18,14,0,36
f3f5941f,11,6,4,6,1,6,18,12,10,1,9,15,26,8,1,47
f4081572,5,2,3,2,0,2,3,1,1,0,1,5,10,6,0,2
f447fcdb,12,7,5,4,3,5,13,8,11,4,7,13,25,16,1,21
f4a8e2ed,3,3,0,2,1,0,1,1,2,0,2,2,5,4,0,12
f4eb377b,0,0,0,0,0,0,1,1,0,0,0,3,3,5,1,14
f5044e54,11,9,6,2,3,5,15,10,11,2,9,9,20,10,0,33
f50a668a,10,8,9,1,0,6,8,2,4,4,0,10,20,25,1,29
f5b6fb78,6,5,3,3,0,1,7,6,1,1,0,2,8,1,0,8
f5eedf74,9,4,2,5,2,2,3,1,4,0,4,3,12,0,0,29
f5efb153,5,2,3,2,0,4,7,3,6,4,2,11,16,32,1,29
f69d4d79,2,0,0,2,0,1,2,1,2,1,1,2,4,7,0,7
f69fba57,4,3,1,2,1,0,4,4,2,0,2,0,4,1,0,12
f6ac68c1,4,4,3,1,0,2,3,1,1,0,1,5,9,23,0,9
f6d4b6b2,0,0,0,0,0,0,0,0,0,0,0,0,0,1,0,0
f7223718,10,7,6,4,0,2,6,4,9,1,8,4,14,15,0,41
f73abe54,9,6,2,6,1,4,7,3,1,0,1,4,13,3,0,37
f7815d38,1,0,1,0,0,0,8,8,6,1,5,1,2,2,0,8
f7aa75bd,6,4,5,1,0,4,6,2,1,1,0,4,10,4,0,14
f7b10c66,0,0,0,0,0,0,0,0,1,0,1,0,0,2,0,8
f7b1d4e0,6,2,2,1,3,3,8,5,8,2,6,4,10,2,0,30
f7dc2ae5,12,6,4,7,1,2,5,3,5,3,2,13,25,10,0,33
f7e87032,10,7,2,7,1,3,6,3,1,0,1,6,16,8,0,44
f814f0f1,5,3,4,1,0,1,5,4,2,0,2,2,7,5,0,17
f833a830,6,5,2,2,2,1,7,6,2,0,2,3,9,2,0,20
f86cabbd,9,8,3,5,1,7,9,2,3,0,3,9,18,9,0,15
f874dd44,14,8,10,3,1,5,16,11,5,1,4,10,24,19,0,31
f8bfb4ae,4,1,3,1,0,3,3,0,5,2,3,8,12,21,0,12
f8eca1b6,0,0,0,0,0,0,0,0,2,0,2,0,0,2,0,7
f9a5c9c1,4,2,1,2,1,1,9,8,5,0,5,8,12,6,0,29
f9c927de,9,3,4,4,1,2,10,8,5,2,3,5,14,2,0,34
fa274d97,12,8,7,3,2,5,11,6,10,0,10,7,19,9,0,28
fa6292e2,9,5,6,2,1,7,11,4,4,2,2,3,12,5,0,42
fa7e8a83,9,8,7,2,0,6,7,1,1,0,1,5,14,2,0,17
faa1b07d,1,1,1,0,0,0,2,2,0,0,0,5,6,4,0,2
fae8f607,11,6,1,7,3,2,7,5,4,1,3,11,22,4,0,50
faed84db,2,2,2,0,0,0,0,0,1,0,1,1,3,3,0,1
fb054320,6,5,4,2,0,1,3,2,7,1,6,3,9,1,1,41
fb2a63bb,6,5,2,4,0,4,7,3,4,0,4,1,7,0,0,17
fb2c533b,10,6,5,5,0,3,8,5,6,2,4,15,25,8,0,46
fb5022e4,4,2,2,2,0,2,4,2,2,1,1,2,6,1,0,11
fb517645,9,9,3,6,0,2,3,1,8,0,8,5,14,6,0,33
fb59286d,9,6,4,3,2,1,15,14,16,2,14,10,19,3,0,22
fb5d47b3,13,10,10,2,1,7,10,3,9,2,7,6,19,16,0,20
fb5eb6e0,0,0,0,0,0,0,0,0,0,0,0,0,0,0,0,2
fbafd1b0,11,8,9,1,1,6,7,1,4,2,2,6,17,10,0,18
fbb23472,21,19,12,8,1,4,21,17,11,1,10,13,34,4,0,86
fc176c8b,0,0,0,0,0,0,0,0,0,0,0,0,0,0,0,0
fc1cf07a,12,11,4,7,1,6,8,2,6,2,4,13,25,14,0,38
fc3f41aa,3,3,1,1,1,0,5,5,2,0,2,3,6,0,0,12
fc4cf6a7,4,3,2,1,1,0,2,2,2,0,2,4,8,8,1,17
fc4f85b1,14,9,13,1,0,9,12,3,6,6,0,12,26,45,0,33
fcb8b607,4,3,2,1,1,2,5,3,6,0,6,4,8,2,0,19
fcd24f5f,0,0,0,0,0,0,0,0,0,0,0,0,0,1,0,4
fce2302c,4,1,1,1,2,1,3,2,3,1,2,2,6,4,0,12
fd2bc67d,11,8,8,3,0,6,11,5,6,2,4,17,28,29,1,46
fd4ee68b,19,12,8,8,3,7,16,9,9,4,5,13,32,6,0,59
fd6f2466,9,5,6,3,0,3,6,3,3,0,3,12,21,5,0,27
fe2db476,5,5,4,1,0,3,6,3,3,0,3,3,8,4,0,21
fe322052,3,2,2,0,1,1,2,1,4,0,4,8,11,3,0,14
fec5accc,1,0,0,0,1,0,5,5,3,2,1,2,3,6,0,27
fefce889,0,0,0,0,0,0,0,0,0,0,0,0,0,1,0,4
ff98492b,2,1,2,0,0,1,2,1,1,0,1,4,6,0,0,6
ffbbc83b,11,9,3,6,2,4,8,4,2,1,1,6,17,4,0,14
ffc3c7ba,3,3,2,0,1,1,3,2,1,1,0,2,5,2,0,22
ffd740c5,18,9,13,5,0,9,20,11,7,0,7,12,30,9,0,31
