id,Player,Nation,Pos,Squad,Age,Born,90s,Tkl,TklW,Def 3rd,Mid 3rd,Att 3rd,Tkl.1,Att,Tkl%,Lost,Blocks,Sh,Pass,Int,Tkl+Int,Clr,Err,Matches
4cd41883,Paxten Aaronson,us USA,MF,Eint Frankfurt,19-220,2003,0.1,0,0,0,0,0,0,0,,0,0,0,0,0,0,0,0,Matches
22919e97,Sargis Adamyan,am ARM,"FW,MF",Köln,29-315,1993,7.0,13,6,4,3,6,6,14,42.9,8,12,0,12,3,16,5,0,Matches
501055d8,Karim Adeyemi,de GER,"FW,MF",Dortmund,21-075,2002,8.9,11,7,3,5,3,6,18,33.3,12,11,0,11,6,17,1,0,Matches
dcfb17f4,Amine Adli,fr FRA,"FW,MF",Leverkusen,22-328,2000,11.0,11,9,3,4,4,3,11,27.3,8,22,2,20,5,16,6,0,Matches
cb6d81b3,Felix Agu,de GER,"DF,FW",Werder Bremen,23-188,1999,0.5,1,0,0,1,0,0,0,,0,1,1,0,0,1,0,0,Matches
a6c58494,Naouirou Ahamada,fr FRA,MF,Stuttgart,21-005,2002,15.5,17,11,7,7,3,8,20,40.0,12,16,5,11,8,25,7,0,Matches
462475ed,Ludovic Ajorque,fr FRA,FW,Mainz 05,29-037,1994,8.2,2,2,1,1,0,0,3,0.0,3,8,2,6,0,2,5,0,Matches
6ec6fde0,Kevin Akpoguma,ng NGA,DF,Hoffenheim,27-349,1995,16.2,62,35,36,23,3,25,35,71.4,10,39,13,26,16,78,44,1,Matches
834d0be5,Lucas Alario,ar ARG,"FW,MF",Eint Frankfurt,30-177,1992,3.4,3,2,1,0,2,0,1,0.0,1,0,0,0,0,3,12,0,Matches
00f518d8,Faride Alidou,de GER,"DF,MF",Eint Frankfurt,21-259,2001,1.5,7,4,3,4,0,3,7,42.9,4,1,0,1,1,8,0,0,Matches
8ce30c57,Éder Álvarez Balanta,co COL,"MF,FW",Schalke 04,30-034,1993,2.6,5,4,2,3,0,2,6,33.3,4,0,0,0,3,8,4,0,Matches
cd682b6b,Lukáš Ambros,cz CZE,MF,Wolfsburg,18-302,2004,0.2,1,0,1,0,0,1,4,25.0,3,1,0,1,0,1,2,1,Matches
555d5edd,Nadiem Amiri,de GER,"MF,FW",Leverkusen,26-158,1996,8.0,9,3,3,5,1,5,12,41.7,7,7,0,7,4,13,9,1,Matches
e0b113a7,Robert Andrich,de GER,MF,Leverkusen,28-193,1994,21.7,49,30,23,22,4,20,32,62.5,12,23,8,15,29,78,43,2,Matches
30941e96,Angeliño,es ESP,DF,Hoffenheim,26-089,1997,21.9,29,17,14,12,3,16,25,64.0,9,23,5,18,19,48,45,0,Matches
5e66fa06,Waldemar Anton,de GER,DF,Stuttgart,26-257,1996,24.8,41,23,22,17,2,22,42,52.4,20,33,12,21,32,73,93,2,Matches
0a3f6cde,Christopher Antwi-Adjei,gh GHA,"FW,MF",Bochum,29-055,1994,14.5,16,11,4,5,7,5,19,26.3,14,10,0,10,3,19,10,0,Matches
56413b1f,Charles Aránguiz,cl CHI,MF,Leverkusen,33-351,1989,5.5,17,7,7,10,0,12,20,60.0,8,4,0,4,7,24,4,0,Matches
86e119e0,Maximilian Arnold,de GER,MF,Wolfsburg,28-311,1994,24.2,47,23,17,23,7,21,43,48.8,22,28,9,19,21,68,53,0,Matches
13ddc856,Takuma Asano,jp JPN,"FW,MF",Bochum,28-144,1994,12.1,7,4,2,2,3,1,5,20.0,4,10,1,9,6,13,3,0,Matches
35f67a30,Fisnik Asllani,xk KVX,FW,Hoffenheim,20-238,2002,1.9,0,0,0,0,0,0,4,0.0,4,2,0,2,3,3,3,0,Matches
fe46e261,Mehmet Aydin,de GER,"DF,FW",Schalke 04,21-053,2002,5.4,23,16,12,9,2,11,21,52.4,10,9,0,9,9,32,12,0,Matches
ce81d82d,Ayman Azhil,ma MAR,MF,Leverkusen,21-358,2001,0.0,0,0,0,0,0,0,0,,0,0,0,0,0,0,0,0,Matches
10549b49,Sardar Azmoun,ir IRN,"FW,MF",Leverkusen,28-092,1995,6.5,5,3,1,3,1,1,7,14.3,6,3,0,3,1,6,7,0,Matches
f582d5c1,Sanoussy Ba,de GER,DF,RB Leipzig,19-088,2004,0.0,0,0,0,0,0,0,0,,0,0,0,0,0,0,0,0,Matches
a8567629,Mitchel Bakker,nl NED,"DF,MF",Leverkusen,22-287,2000,12.9,12,7,6,6,0,3,8,37.5,5,14,2,12,10,22,14,2,Matches
442b56fa,Ridle Baku,de GER,DF,Wolfsburg,24-360,1998,23.1,39,17,23,13,3,24,46,52.2,22,39,6,33,19,58,45,0,Matches
a2a85828,Aymen Barkok,ma MAR,MF,Mainz 05,24-317,1998,4.6,14,7,9,3,2,3,6,50.0,3,5,0,5,3,17,7,0,Matches
00242b75,Leandro Barreiro Martins,lu LUX,MF,Mainz 05,23-090,2000,17.7,41,25,12,20,9,14,31,45.2,17,30,11,19,29,70,25,0,Matches
e61bdd69,Gil Bastião Dias,pt POR,FW,Stuttgart,26-187,1996,4.4,8,6,3,4,1,3,12,25.0,9,7,0,7,2,10,3,0,Matches
44a20f0c,Maximilian Bauer,de GER,DF,Augsburg,23-053,2000,14.7,24,13,17,7,0,15,26,57.7,11,20,8,12,21,45,61,0,Matches
47064058,Oliver Baumann,de GER,GK,Hoffenheim,32-305,1990,26.0,0,0,0,0,0,0,0,,0,0,0,0,0,0,11,1,Matches
bd7d2e6d,Timo Baumgartl,de GER,DF,Union Berlin,27-030,1996,5.7,9,5,5,2,2,4,17,23.5,13,11,3,8,1,10,14,0,Matches
69374ff5,Julian Baumgartlinger,at AUT,MF,Augsburg,35-091,1988,5.2,14,3,5,5,4,6,16,37.5,10,4,2,2,4,18,15,0,Matches
437f2b00,Christoph Baumgartner,at AUT,"MF,FW",Hoffenheim,23-245,1999,22.0,30,16,9,15,6,6,38,15.8,32,50,5,45,13,43,15,1,Matches
fbbc8e15,Noah Joel Sarenren Bazee,ng NGA,FW,Augsburg,26-225,1996,0.1,0,0,0,0,0,0,1,0.0,1,1,0,1,0,0,0,0,Matches
a53b661f,Ihlas Bebou,tg TOG,FW,Hoffenheim,28-345,1994,8.1,9,9,1,5,3,4,7,57.1,3,8,1,7,4,13,3,0,Matches
8eb55dbb,Sheraldo Becker,sr SUR,FW,Union Berlin,28-053,1995,20.8,10,4,0,5,5,1,7,14.3,6,7,1,6,2,12,4,1,Matches
30ae134d,Kevin Behrens,de GER,FW,Union Berlin,32-059,1991,11.4,8,6,3,2,3,3,12,25.0,9,12,2,10,4,12,19,0,Matches
857a5abe,Stefan Bell,de GER,DF,Mainz 05,31-222,1991,18.7,29,17,24,5,0,15,29,51.7,14,27,12,15,37,66,93,0,Matches
bee0bab1,Karim Bellarabi,de GER,FW,Leverkusen,32-360,1990,0.9,2,0,1,1,0,2,2,100.0,0,0,0,0,0,2,0,0,Matches
57d88cf9,Jude Bellingham,eng ENG,MF,Dortmund,19-278,2003,24.1,63,33,23,27,13,30,40,75.0,10,43,3,40,29,92,22,0,Matches
378825c7,Ramy Bensebaini,dz ALG,DF,M'Gladbach,27-352,1995,21.8,33,21,20,10,3,25,34,73.5,9,34,11,23,27,60,78,1,Matches
eb6e14be,Mergim Berisha,de GER,FW,Augsburg,24-327,1998,17.5,11,6,4,3,4,4,13,30.8,9,13,1,12,0,11,19,0,Matches
7aac47fe,Ermin Bičakčić,ba BIH,DF,Hoffenheim,33-069,1990,1.9,3,0,2,1,0,1,4,25.0,3,2,1,1,4,7,5,0,Matches
07d3bfec,Tom Bischof,de GER,"MF,FW",Hoffenheim,17-279,2005,2.9,11,7,4,3,4,5,7,71.4,2,4,0,4,0,11,0,0,Matches
dc62fbee,Leonardo Bittencourt,de GER,"MF,DF",Werder Bremen,29-105,1993,11.6,27,16,5,16,6,11,24,45.8,13,7,0,7,9,36,7,0,Matches
663e080e,Janis Blaswich,de GER,GK,RB Leipzig,31-336,1991,19.0,0,0,0,0,0,0,0,,0,0,0,0,0,0,6,0,Matches
691bef82,Daley Blind,nl NED,"DF,MF",Bayern Munich,33-025,1990,1.5,2,0,2,0,0,0,1,0.0,1,4,2,2,2,4,6,0,Matches
f4ec4fd0,Kevin-Prince Boateng,gh GHA,MF,Hertha BSC,36-028,1987,2.6,6,4,3,2,1,1,6,16.7,5,4,2,2,0,6,4,0,Matches
635f2732,Jean-Paul Boëtius,nl NED,MF,Hertha BSC,29-012,1994,9.5,24,14,15,7,2,6,18,33.3,12,18,1,17,11,35,8,0,Matches
36578017,Yvandro Borges Sanches,lu LUX,"FW,MF",M'Gladbach,18-314,2004,0.3,2,2,0,2,0,2,2,100.0,0,0,0,0,0,2,0,0,Matches
01834aa0,Sebastiaan Bornauw,be BEL,DF,Wolfsburg,24-012,1999,14.9,15,10,9,5,1,7,12,58.3,5,18,9,9,23,38,62,0,Matches
c68da769,Rafael Borré,co COL,"FW,MF",Eint Frankfurt,27-200,1995,8.7,19,14,4,9,6,2,10,20.0,8,7,1,6,2,21,5,0,Matches
a167537f,Julian Brandt,de GER,"MF,FW",Dortmund,26-336,1996,20.0,20,14,3,11,6,9,27,33.3,18,15,0,15,15,35,6,1,Matches
d28339cb,Fabian Bredlow,de GER,GK,Stuttgart,28-032,1995,7.0,0,0,0,0,0,0,0,,0,0,0,0,0,0,3,1,Matches
d4a2533d,Josip Brekalo,hr CRO,"MF,FW",Wolfsburg,24-284,1998,3.0,2,1,2,0,0,0,4,0.0,4,0,0,0,2,4,2,0,Matches
e27da244,John Brooks,us USA,DF,Hoffenheim,30-065,1993,7.0,9,6,3,6,0,7,10,70.0,3,5,1,4,8,17,40,0,Matches
bbd79358,Moritz Broschinski,de GER,"FW,MF",Bochum,22-192,2000,1.2,0,0,0,0,0,0,2,0.0,2,0,0,0,0,0,4,0,Matches
f0a37d36,Cédric Brunner,ch SUI,DF,Schalke 04,29-045,1994,20.6,31,22,21,8,2,25,37,67.6,12,21,6,15,35,66,64,0,Matches
4e204552,Jacob Bruun Larsen,dk DEN,FW,Hoffenheim,24-196,1998,3.3,3,2,0,0,3,2,2,100.0,0,2,0,2,1,4,0,0,Matches
45e95f21,Lee Buchanan,eng ENG,"DF,FW",Werder Bremen,22-027,2001,3.6,10,7,2,8,0,6,8,75.0,2,4,0,4,8,18,10,0,Matches
ab5b7dc1,Marius Bülter,de GER,"FW,MF",Schalke 04,30-005,1993,22.3,18,10,8,6,4,10,25,40.0,15,26,1,25,10,28,13,0,Matches
05e2d5ea,Delano Burgzorg,nl NED,"FW,MF",Mainz 05,24-147,1998,2.4,3,3,1,1,1,2,3,66.7,1,2,0,2,0,3,1,0,Matches
05f99a4a,Jonathan Burkardt,de GER,"MF,FW",Mainz 05,22-266,2000,5.9,3,1,0,1,2,1,4,25.0,3,6,1,5,1,4,1,0,Matches
f631c17f,Oliver Burke,sct SCO,"FW,MF",Werder Bremen,25-361,1997,3.0,1,0,0,0,1,0,0,,0,2,0,2,0,1,0,0,Matches
b4705807,Aurélio Buta,pt POR,DF,Eint Frankfurt,26-052,1997,7.5,19,10,10,9,0,8,13,61.5,5,8,1,7,5,24,17,0,Matches
10745192,Jamie Bynoe-Gittens,eng ENG,"FW,MF",Dortmund,18-238,2004,5.4,7,4,2,4,1,2,6,33.3,4,0,0,0,0,7,2,0,Matches
0118c54c,Anthony Caci,fr FRA,DF,Mainz 05,25-276,1997,17.0,41,20,24,12,5,17,26,65.4,9,17,4,13,44,85,30,0,Matches
d1db4b83,Kerim Calhanoglu,de GER,DF,Schalke 04,20-220,2002,0.7,2,1,2,0,0,2,2,100.0,0,1,0,1,0,2,3,0,Matches
d1273f09,Daniel Caligiuri,it ITA,"DF,MF",Augsburg,35-078,1988,2.9,8,5,5,3,0,4,5,80.0,1,2,2,0,3,11,2,0,Matches
a65ce836,Emre Can,de GER,MF,Dortmund,29-081,1994,13.1,45,20,18,22,5,16,31,51.6,15,8,1,7,17,62,24,1,Matches
bd6351cd,João Cancelo,pt POR,"DF,FW",Bayern Munich,28-311,1994,4.1,13,10,5,6,2,4,11,36.4,7,5,1,4,5,18,8,0,Matches
5e080f73,Irvin Cardona,fr FRA,"MF,FW",Augsburg,25-238,1997,1.5,1,1,1,0,0,1,4,25.0,3,2,0,2,2,3,5,0,Matches
db401046,Koen Casteels,be BEL,GK,Wolfsburg,30-282,1992,26.0,0,0,0,0,0,0,0,,0,0,0,0,1,1,8,0,Matches
ae7058f9,Julian Chabot,de GER,DF,Köln,25-050,1998,12.0,30,21,17,10,3,16,26,61.5,10,18,11,7,24,54,67,0,Matches
b3b7f5a6,Timothy Chandler,us USA,DF,Eint Frankfurt,33-005,1990,0.9,2,2,2,0,0,2,2,100.0,0,1,0,1,0,2,3,0,Matches
48780156,Fabio Chiarodia,it ITA,DF,Werder Bremen,17-302,2005,0.7,0,0,0,0,0,0,0,,0,1,0,1,2,2,4,0,Matches
af104654,Oliver Christensen,dk DEN,GK,Hertha BSC,24-012,1999,26.0,1,0,1,0,0,0,1,0.0,1,0,0,0,0,1,18,1,Matches
c6608135,Darko Churlinov,mk MKD,FW,Stuttgart,22-266,2000,0.3,3,2,2,1,0,2,3,66.7,1,1,0,1,0,3,0,0,Matches
6e17c802,Tolga Ciğerci,tr TUR,MF,Hertha BSC,31-011,1992,6.0,12,9,6,5,1,7,13,53.8,6,4,2,2,6,18,5,0,Matches
dd5bbe0d,David Čolina,hr CRO,"DF,MF",Augsburg,22-258,2000,0.7,2,0,1,1,0,1,1,100.0,0,4,0,4,3,5,0,0,Matches
042e8a49,Kingsley Coman,fr FRA,"FW,MF",Bayern Munich,26-294,1996,11.1,10,7,3,5,2,6,12,50.0,6,17,1,16,1,11,4,0,Matches
5ddb8f9f,Danny da Costa,de GER,DF,Mainz 05,29-264,1993,10.9,14,13,3,7,4,6,12,50.0,6,20,3,17,9,23,21,0,Matches
05ba9d7c,Tanguy Coulibaly,fr FRA,"FW,DF",Stuttgart,22-044,2001,2.5,11,9,7,2,2,5,9,55.6,4,7,0,7,3,14,0,0,Matches
8f325097,Nicolas Cozza,fr FRA,DF,Wolfsburg,24-085,1999,0.2,0,0,0,0,0,0,0,,0,0,0,0,0,0,0,0,Matches
eac044ad,Moanes Dabbur,il ISR,FW,Hoffenheim,30-324,1992,7.3,8,5,2,5,1,3,6,50.0,3,4,0,4,3,11,0,0,Matches
dee3013b,Finn Dahmen,de GER,GK,Mainz 05,25-007,1998,6.0,0,0,0,0,0,0,0,,0,0,0,0,0,0,0,0,Matches
db4ed67b,Mahmoud Dahoud,de GER,MF,Dortmund,27-092,1996,3.7,11,9,3,4,4,7,7,100.0,0,6,2,4,7,18,3,0,Matches
d3d77413,Muhammed Damar,de GER,MF,Hoffenheim,18-359,2004,1.8,6,3,1,2,3,1,2,50.0,1,3,0,3,0,6,0,0,Matches
41bff4fa,Márton Dárdai,de GER,DF,Hertha BSC,21-050,2002,5.9,11,7,6,5,0,5,8,62.5,3,4,1,3,6,17,30,1,Matches
3eb0f2df,Vladimír Darida,cz CZE,MF,Hertha BSC,32-238,1990,0.3,1,1,0,1,0,0,0,,0,1,0,1,0,1,0,0,Matches
d781d855,Alphonso Davies,ca CAN,DF,Bayern Munich,22-152,2000,21.3,43,27,24,12,7,18,38,47.4,20,26,4,22,23,66,21,3,Matches
fe641c1a,Thomas Delaney,dk DEN,MF,Hoffenheim,31-212,1991,3.3,6,3,3,2,1,3,8,37.5,5,5,0,5,1,7,4,0,Matches
54b4dc4e,Kerem Demirbay,de GER,MF,Leverkusen,29-274,1993,13.2,28,14,12,13,3,15,27,55.6,12,19,4,15,13,41,6,0,Matches
ed79b7d3,Ermedin Demirović,ba BIH,"FW,MF",Augsburg,25-009,1998,20.6,28,13,8,11,9,9,18,50.0,9,27,4,23,14,42,29,0,Matches
7bf9400b,Sepp van den Berg,nl NED,DF,Schalke 04,21-104,2001,3.6,2,1,1,1,0,0,0,,0,4,2,2,8,10,19,1,Matches
aeed5c06,Moussa Diaby,fr FRA,"FW,MF",Leverkusen,23-270,1999,22.7,12,7,3,8,1,7,14,50.0,7,6,0,6,4,16,3,0,Matches
fc62f087,Abdou Diallo,sn SEN,"DF,MF",RB Leipzig,26-334,1996,4.8,6,5,5,1,0,1,3,33.3,2,4,3,1,7,13,18,0,Matches
d82a310a,Justin Diehl,de GER,"MF,FW",Köln,18-127,2004,0.2,0,0,0,0,0,0,0,,0,0,0,0,0,0,0,0,Matches
8779ddf8,Florian Dietz,de GER,FW,Köln,24-243,1998,4.4,2,1,0,2,0,1,4,25.0,3,4,1,3,0,2,2,0,Matches
95bb6ddc,Junior Dina Ebimbe,fr FRA,"DF,MF",Eint Frankfurt,22-133,2000,8.7,24,16,12,12,0,13,23,56.5,10,12,4,8,7,31,12,0,Matches
4ccd8957,Eren Dinkçi,de GER,"FW,MF",Werder Bremen,21-111,2001,2.0,4,4,2,0,2,1,4,25.0,3,2,0,2,0,4,1,0,Matches
d01bbb6f,Ritsu Doan,jp JPN,"FW,MF",Freiburg,24-291,1998,20.7,47,20,12,25,10,20,42,47.6,22,33,1,32,10,57,7,0,Matches
f67c9d29,Danilho Doekhi,nl NED,DF,Union Berlin,24-277,1998,16.6,25,17,14,11,0,11,18,61.1,7,20,9,11,21,46,63,0,Matches
cc83b74d,Kasper Dolberg,dk DEN,"FW,MF",Hoffenheim,25-179,1997,3.8,6,5,0,4,2,4,5,80.0,1,5,2,3,0,6,2,0,Matches
7f73bdf4,Niklas Dorsch,de GER,MF,Augsburg,25-078,1998,2.1,12,6,4,8,0,4,7,57.1,3,4,1,3,1,13,2,0,Matches
9a2e3a23,Dion Drena Beljo,hr CRO,"FW,MF",Augsburg,21-033,2002,6.3,6,5,2,2,2,2,8,25.0,6,9,1,8,1,7,6,0,Matches
809940aa,Dominick Drexler,de GER,"MF,FW",Schalke 04,32-312,1990,11.8,18,13,9,7,2,5,16,31.3,11,14,1,13,4,22,9,0,Matches
638a4d71,Marvin Ducksch,de GER,FW,Werder Bremen,29-027,1994,24.2,7,3,1,4,2,2,12,16.7,10,7,0,7,6,13,33,1,Matches
79ca3e23,Ondrej Duda,sk SVK,MF,Köln,28-119,1994,7.7,9,8,2,5,2,4,11,36.4,7,7,1,6,2,11,3,0,Matches
beb882a8,Maximilian Eggestein,de GER,MF,Freiburg,26-116,1996,21.3,37,19,12,19,6,13,23,56.5,10,30,6,24,26,63,17,0,Matches
2f7fec15,Lilian Egloff,de GER,"MF,FW",Stuttgart,20-226,2002,2.7,12,10,4,5,3,4,6,66.7,2,2,0,2,1,13,1,0,Matches
76b2817e,Kingsley Ehizibue,nl NED,DF,Köln,27-313,1995,0.7,0,0,0,0,0,0,0,,0,1,0,1,2,2,1,0,Matches
e7f3e8a7,Chidera Ejuke,ng NGA,"FW,MF",Hertha BSC,25-091,1998,8.8,4,3,1,3,0,1,4,25.0,3,3,0,3,2,6,0,0,Matches
48035304,Nico Elvedi,ch SUI,DF,M'Gladbach,26-185,1996,23.5,41,20,28,11,2,25,31,80.6,6,20,9,11,27,68,109,3,Matches
c149016b,Wataru Endo,jp JPN,MF,Stuttgart,30-053,1993,24.5,54,31,23,25,6,27,59,45.8,32,32,6,26,23,77,49,0,Matches
554bcc91,Arne Engels,be BEL,MF,Augsburg,19-207,2003,10.2,17,7,8,8,1,7,12,58.3,5,9,3,6,10,27,7,0,Matches
1e43fad8,Ralf Fährmann,de GER,GK,Schalke 04,34-188,1988,9.0,0,0,0,0,0,0,0,,0,0,0,0,0,0,6,2,Matches
677da306,Ohis Felix Uduokhai,de GER,DF,Augsburg,25-206,1997,10.8,24,16,12,10,2,13,21,61.9,8,17,8,9,18,42,46,1,Matches
3bb625ac,Edimilson Fernandes,ch SUI,DF,Mainz 05,26-353,1996,19.7,27,19,20,4,3,12,22,54.5,10,35,15,20,42,69,61,2,Matches
79f7302a,Kilian Fischer,de GER,DF,Wolfsburg,22-173,2000,4.2,6,4,3,3,0,4,8,50.0,4,4,0,4,5,11,12,0,Matches
a92ab7be,Mark Flekken,nl NED,GK,Freiburg,29-294,1993,26.0,0,0,0,0,0,0,1,0.0,1,0,0,0,0,0,6,3,Matches
9642c929,Florian Flick,de GER,MF,Schalke 04,22-337,2000,5.7,12,3,7,5,0,4,14,28.6,10,9,3,6,4,16,18,0,Matches
9a2e0ccc,Emil Forsberg,se SWE,"MF,FW",RB Leipzig,31-162,1991,13.2,13,11,1,5,7,5,15,33.3,10,19,0,19,3,16,5,0,Matches
76fa965f,Philipp Förster,de GER,MF,Bochum,28-058,1995,11.4,24,16,10,10,4,7,30,23.3,23,18,0,18,4,28,4,0,Matches
a9142dc3,Timothy Fosu-Mensah,nl NED,DF,Leverkusen,25-091,1998,2.0,7,5,3,3,1,4,4,100.0,0,2,0,2,0,7,1,0,Matches
626fab5f,Raphael Framberger,de GER,"DF,FW",Augsburg,27-209,1995,2.0,10,6,6,4,0,3,5,60.0,2,2,1,1,2,12,5,0,Matches
697dc00a,Bartol Franjić,hr CRO,MF,Wolfsburg,23-079,2000,2.5,4,2,2,2,0,0,2,0.0,2,4,1,3,5,9,4,0,Matches
458e3479,Oscar Fraulo,dk DEN,MF,M'Gladbach,19-118,2003,0.0,0,0,0,0,0,0,0,,0,0,0,0,0,0,0,0,Matches
33182cb8,Michael Frey,ch SUI,FW,Schalke 04,28-258,1994,7.5,10,4,1,6,3,2,11,18.2,9,5,0,5,1,11,1,0,Matches
f86ad3f5,Marco Friedl,at AUT,DF,Werder Bremen,25-018,1998,20.8,42,30,27,15,0,25,44,56.8,19,34,13,21,47,89,85,1,Matches
b77f44a4,Marvin Friedrich,de GER,DF,M'Gladbach,27-111,1995,10.7,13,9,10,2,1,8,10,80.0,2,9,4,5,11,24,39,0,Matches
74f2e748,Jeremie Frimpong,nl NED,"DF,MF",Leverkusen,22-114,2000,22.3,43,21,20,20,3,18,32,56.3,14,18,1,17,12,55,34,0,Matches
0cf778df,Chris Führich,de GER,"FW,MF",Stuttgart,25-084,1998,17.0,32,13,14,13,5,21,38,55.3,17,27,2,25,7,39,10,0,Matches
4b96c347,Angelo Fulgini,fr FRA,MF,Mainz 05,26-226,1996,5.8,6,5,2,3,1,5,12,41.7,7,5,0,5,5,11,7,0,Matches
4f16405e,Niclas Füllkrug,de GER,FW,Werder Bremen,30-053,1993,24.5,9,4,0,6,3,3,12,25.0,9,12,4,8,1,10,24,0,Matches
f27680d9,Cristian Gamboa,cr CRC,DF,Bochum,33-161,1989,14.1,37,20,26,10,1,17,25,68.0,8,17,6,11,14,51,31,1,Matches
6c731625,Silvère Ganvoula M'Boussy,cg CGO,"FW,MF",Bochum,26-285,1996,2.6,2,2,0,1,1,0,0,,0,0,0,0,0,2,3,0,Matches
37f606f0,Dennis Geiger,de GER,MF,Hoffenheim,24-297,1998,16.9,31,18,11,19,1,14,25,56.0,11,21,3,18,15,46,10,1,Matches
62ab9184,Yannick Gerhardt,de GER,MF,Wolfsburg,29-021,1994,16.4,24,13,8,10,6,10,22,45.5,12,21,2,19,6,30,22,0,Matches
7242b495,Niko Gießelmann,de GER,DF,Union Berlin,31-189,1991,13.3,19,10,8,8,3,12,27,44.4,15,17,5,12,9,28,25,0,Matches
17376543,Rafał Gikiewicz,pl POL,GK,Augsburg,35-159,1987,22.0,2,2,2,0,0,2,3,66.7,1,0,0,0,0,2,14,4,Matches
f521b80a,Matthias Ginter,de GER,DF,Freiburg,29-074,1994,26.0,35,15,22,11,2,21,34,61.8,13,30,18,12,31,66,113,3,Matches
88e357ef,Serge Gnabry,de GER,"FW,MF",Bayern Munich,27-263,1995,14.9,23,15,7,8,8,9,20,45.0,11,19,1,18,8,31,3,1,Matches
83b9c48f,Jacek Góralski,pl POL,MF,Bochum,30-194,1992,1.6,6,3,3,3,0,4,6,66.7,2,4,0,4,3,9,5,0,Matches
cc86b9a3,Leon Goretzka,de GER,MF,Bayern Munich,28-056,1995,15.6,35,23,18,11,6,21,37,56.8,16,33,3,30,23,58,25,0,Matches
9efa1d25,Mario Götze,de GER,MF,Eint Frankfurt,30-304,1992,23.5,35,20,12,16,7,9,35,25.7,26,19,0,19,13,48,7,0,Matches
1025db8e,Jeffrey Gouweleeuw,nl NED,DF,Augsburg,31-267,1991,24.1,39,24,17,16,6,23,43,53.5,20,33,20,13,42,81,115,2,Matches
b8e740fb,Ryan Gravenberch,nl NED,MF,Bayern Munich,20-322,2002,3.6,10,6,1,8,1,5,10,50.0,5,3,1,2,4,14,5,0,Matches
8e235926,Michael Gregoritsch,at AUT,FW,Freiburg,28-350,1994,19.8,16,9,6,6,4,2,16,12.5,14,20,3,17,4,20,10,0,Matches
f9dfb7ae,Leo Greiml,at AUT,DF,Schalke 04,21-274,2001,3.5,5,2,1,3,1,5,11,45.5,6,7,3,4,2,7,15,0,Matches
54e4866f,Vincenzo Grifo,it ITA,"FW,MF",Freiburg,29-361,1993,19.7,20,11,4,9,7,8,23,34.8,15,9,1,8,11,31,13,0,Matches
37998008,Lennart Grill,de GER,GK,Union Berlin,24-068,1999,5.0,0,0,0,0,0,0,1,0.0,1,0,0,0,0,0,1,1,Matches
14a7af33,Christian Groß,de GER,MF,Werder Bremen,34-054,1989,16.1,44,20,13,29,2,23,49,46.9,26,17,5,12,18,62,33,1,Matches
ae9b998d,Brajan Gruda,de GER,MF,Mainz 05,18-307,2004,0.0,0,0,0,0,0,0,0,,0,0,0,0,0,0,0,0,Matches
1fc4f3d1,Ilia Gruev,bg BUL,MF,Werder Bremen,22-332,2000,14.5,36,22,12,21,3,16,26,61.5,10,19,5,14,19,55,16,1,Matches
f2dd9a21,Carlos Gruezo,ec ECU,MF,Augsburg,27-349,1995,10.7,21,12,12,9,0,9,16,56.3,7,13,4,9,10,31,15,0,Matches
048a1cbc,Raphaël Guerreiro,pt POR,"DF,MF",Dortmund,29-102,1993,19.4,28,14,10,12,6,16,27,59.3,11,13,1,12,27,55,15,0,Matches
e6c43eec,Josuha Guilavogui,fr FRA,"MF,DF",Wolfsburg,32-196,1990,7.0,11,7,1,9,1,3,13,23.1,10,12,7,5,11,22,26,0,Matches
923f4dda,Sehrou Guirassy,gn GUI,FW,Stuttgart,27-022,1996,11.1,2,1,1,1,0,1,1,100.0,0,5,1,4,0,2,10,0,Matches
bcb2ccd8,Péter Gulácsi,hu HUN,GK,RB Leipzig,32-332,1990,6.0,0,0,0,0,0,0,0,,0,0,0,0,0,0,2,0,Matches
25ab9c9c,Manuel Gulde,de GER,DF,Freiburg,32-050,1991,4.6,9,6,7,2,0,1,1,100.0,0,3,0,3,10,19,19,0,Matches
1df0c0b9,Robert Gumny,pl POL,DF,Augsburg,24-303,1998,19.7,29,20,11,14,4,9,23,39.1,14,19,7,12,22,51,54,1,Matches
8593f88c,Christian Günter,de GER,"DF,MF",Freiburg,30-034,1993,24.6,24,16,14,8,2,10,34,29.4,24,15,4,11,13,37,29,0,Matches
5ad50391,Joško Gvardiol,hr CRO,DF,RB Leipzig,21-070,2002,19.3,17,12,11,6,0,6,16,37.5,10,30,14,16,26,43,62,1,Matches
70dcf94d,Janik Haberer,de GER,MF,Union Berlin,29-001,1994,17.8,20,12,6,11,3,13,35,37.1,22,27,1,26,9,29,19,0,Matches
a5ec3ede,Alexander Hack,de GER,DF,Mainz 05,29-207,1993,12.5,29,17,20,9,0,18,32,56.3,14,16,5,11,24,53,45,1,Matches
cd82452e,André Hahn,de GER,"FW,MF",Augsburg,32-233,1990,4.3,9,5,4,4,1,8,12,66.7,4,9,2,7,4,13,14,0,Matches
92432bc6,Amadou Haidara,ml MLI,MF,RB Leipzig,25-062,1998,10.5,15,6,8,7,0,7,24,29.2,17,19,4,15,18,33,13,0,Matches
ba115a40,Sébastien Haller,ci CIV,FW,Dortmund,28-285,1994,6.9,0,0,0,0,0,0,2,0.0,2,4,0,4,0,0,5,0,Matches
8ff2354e,Marcel Halstenberg,de GER,DF,RB Leipzig,31-188,1991,14.1,31,17,16,10,5,17,31,54.8,14,21,1,20,15,46,19,0,Matches
2e77d607,Andreas Hanche-Olsen,no NOR,DF,Mainz 05,26-076,1997,9.6,22,15,16,3,3,14,24,58.3,10,9,5,4,19,41,41,2,Matches
f24ea523,Genki Haraguchi,jp JPN,MF,Stuttgart,31-329,1991,7.4,15,7,6,7,2,3,12,25.0,9,12,2,10,8,23,5,0,Matches
f24ea523,Genki Haraguchi,jp JPN,MF,Union Berlin,31-329,1991,5.5,12,8,1,10,1,3,9,33.3,6,7,1,6,3,15,9,0,Matches
9ab16552,Makoto Hasebe,jp JPN,DF,Eint Frankfurt,39-075,1984,9.1,13,8,11,2,0,5,15,33.3,10,17,7,10,9,22,31,0,Matches
50871bcc,Thorgan Hazard,be BEL,"FW,DF",Dortmund,30-005,1993,5.2,17,6,5,11,1,12,17,70.6,5,6,0,6,5,22,5,0,Matches
c2009df3,Jonas Hector,de GER,DF,Köln,32-311,1990,23.4,76,41,43,26,7,45,77,58.4,32,46,4,42,31,107,52,0,Matches
699fb8db,Dominique Heintz,de GER,DF,Bochum,29-231,1993,5.6,7,5,4,3,0,3,10,30.0,7,9,5,4,9,16,29,0,Matches
0a89e877,Benjamin Henrichs,de GER,"DF,MF",RB Leipzig,26-039,1997,18.9,62,39,35,25,2,37,55,67.3,18,39,4,35,27,89,33,0,Matches
c3ee18ef,Lucas Hernández,fr FRA,DF,Bayern Munich,27-048,1996,5.3,6,4,3,3,0,5,6,83.3,1,2,1,1,5,11,7,0,Matches
dfb6490a,Patrick Herrmann,de GER,"FW,MF",M'Gladbach,32-050,1991,1.7,6,2,4,1,1,2,4,50.0,2,2,0,2,2,8,0,0,Matches
0c7a48f8,Piero Hincapié,ec ECU,DF,Leverkusen,21-084,2002,20.5,38,25,22,14,2,18,28,64.3,10,31,15,16,24,62,63,1,Matches
5521f419,Adam Hložek,cz CZE,"FW,MF",Leverkusen,20-252,2002,11.4,8,3,4,3,1,2,5,40.0,3,8,2,6,5,13,8,0,Matches
5d8e331f,Nicolas Höfler,de GER,MF,Freiburg,33-025,1990,24.4,52,28,20,30,2,21,44,47.7,23,36,12,24,41,93,36,0,Matches
2903a856,Jonas Hofmann,de GER,"FW,MF",M'Gladbach,30-263,1992,22.6,21,11,13,7,1,9,37,24.3,28,28,2,26,14,35,16,0,Matches
877bc844,Philipp Hofmann,de GER,FW,Bochum,30-004,1993,22.1,12,7,0,8,4,4,9,44.4,5,17,7,10,6,18,32,0,Matches
ca618d23,Lucas Höler,de GER,"FW,MF",Freiburg,28-267,1994,9.1,9,6,2,4,3,3,9,33.3,6,14,3,11,6,15,15,0,Matches
2979c05a,Gerrit Holtmann,ph PHI,FW,Bochum,28-009,1995,9.5,12,6,6,5,1,10,16,62.5,6,14,1,13,2,14,2,0,Matches
2b83fa49,Jannes Horn,de GER,"DF,FW",Bochum,26-056,1997,0.7,2,1,1,1,0,1,1,100.0,0,1,0,1,3,5,2,0,Matches
ad3389d5,Lukáš Hrádecký,fi FIN,GK,Leverkusen,33-130,1989,25.0,0,0,0,0,0,0,0,,0,0,0,0,0,0,3,1,Matches
94302c52,Timo Hübers,de GER,DF,Köln,26-257,1996,20.4,36,21,29,7,0,20,39,51.3,19,22,10,12,42,78,108,0,Matches
15f3ec41,Callum Hudson-Odoi,eng ENG,"FW,MF",Leverkusen,22-147,2000,6.7,5,3,4,0,1,1,1,100.0,0,0,0,0,2,7,4,0,Matches
05d548d8,Mats Hummels,de GER,DF,Dortmund,34-108,1988,15.6,43,21,23,19,1,22,38,57.9,16,21,12,9,25,68,68,1,Matches
b116c6e3,Denis Huseinbasic,de GER,"MF,FW",Köln,21-274,2001,7.7,22,9,7,11,4,10,22,45.5,12,16,2,14,4,26,5,0,Matches
054849d2,Iago,br BRA,"DF,MF",Augsburg,26-011,1997,15.7,30,14,18,9,3,10,24,41.7,14,15,4,11,13,43,50,0,Matches
f5c4fd91,Arijon Ibrahimović,de GER,MF,Bayern Munich,17-113,2005,0.2,1,1,1,0,0,0,0,,0,0,0,0,0,1,0,0,Matches
271b8617,Marcus Ingvartsen,dk DEN,"FW,MF",Mainz 05,27-089,1996,11.3,3,1,0,1,2,1,8,12.5,7,8,1,7,2,5,9,0,Matches
97d545ae,Ko Itakura,jp JPN,DF,M'Gladbach,26-066,1997,15.6,13,8,7,4,2,6,17,35.3,11,30,19,11,20,33,63,0,Matches
204dded0,Hiroki Ito,jp JPN,DF,Stuttgart,23-326,1999,22.5,28,21,17,9,2,15,30,50.0,15,33,14,19,31,59,81,0,Matches
8bf58a80,Andreas Ivan,ro ROU,MF,Schalke 04,28-083,1995,0.5,0,0,0,0,0,0,1,0.0,1,0,0,0,0,0,1,0,Matches
34b0387f,Lee Jae-sung,kr KOR,MF,Mainz 05,30-236,1992,16.4,29,14,7,17,5,11,28,39.3,17,26,5,21,11,40,13,0,Matches
a93b6f4e,Paul Jaeckel,de GER,DF,Union Berlin,24-255,1998,9.9,18,13,7,11,0,13,24,54.2,11,8,3,5,13,31,33,1,Matches
a8ee54ad,Kristijan Jakić,hr CRO,"DF,MF",Eint Frankfurt,25-324,1997,15.0,31,19,19,10,2,21,38,55.3,17,31,10,21,10,41,49,1,Matches
fa4cabd1,Jan Jakob Olschowsky,de GER,GK,M'Gladbach,21-136,2001,2.0,0,0,0,0,0,0,1,0.0,1,0,0,0,0,0,1,0,Matches
689c9cf4,Saidy Janko,gm GAM,DF,Bochum,27-163,1995,9.0,18,11,12,4,2,9,15,60.0,6,16,4,12,10,28,22,1,Matches
34b54da7,Tony Jantschke,de GER,"DF,MF",M'Gladbach,32-361,1990,1.0,2,1,1,1,0,1,1,100.0,0,4,2,2,0,2,5,0,Matches
3eeb80e0,Fredrik Jensen,fi FIN,"FW,MF",Augsburg,25-206,1997,8.8,13,9,7,3,3,5,10,50.0,5,11,5,6,3,16,12,0,Matches
ee644761,Moritz Jenz,de GER,DF,Schalke 04,23-338,1999,8.0,12,9,6,5,1,4,6,66.7,2,13,8,5,7,19,36,1,Matches
f36c432f,Stevan Jovetić,me MNE,"FW,MF",Hertha BSC,33-152,1989,5.7,2,1,1,1,0,1,3,33.3,2,1,1,0,0,2,4,0,Matches
de838f86,Anthony Jung,de GER,"DF,FW",Werder Bremen,31-151,1991,22.7,40,24,16,17,7,28,45,62.2,17,23,3,20,18,58,42,0,Matches
0a084b35,Josip Juranović,hr CRO,DF,Union Berlin,27-230,1995,5.0,3,2,1,1,1,3,5,60.0,2,6,1,5,1,4,8,1,Matches
2d61d13a,Ozan Kabak,tr TUR,DF,Hoffenheim,23-009,2000,20.7,41,28,22,16,3,12,21,57.1,9,24,14,10,41,82,64,0,Matches
79c90e45,Pavel Kadeřábek,cz CZE,DF,Hoffenheim,30-343,1992,14.7,21,15,10,8,3,11,17,64.7,6,9,2,7,9,30,29,1,Matches
94c18565,Florian Kainz,at AUT,"FW,MF",Köln,30-161,1992,19.4,19,9,6,11,2,7,17,41.2,10,23,4,19,24,43,26,1,Matches
15f24fe7,Sasa Kalajdzic,at AUT,FW,Stuttgart,25-270,1997,2.6,3,2,0,1,2,1,3,33.3,2,1,0,1,0,3,0,0,Matches
15b287da,Daichi Kamada,jp JPN,"MF,FW",Eint Frankfurt,26-241,1996,18.5,35,21,6,27,2,21,40,52.5,19,23,2,21,14,49,13,1,Matches
202b3b68,Jakub Kamiński,pl POL,"FW,MF",Wolfsburg,20-302,2002,15.7,22,14,7,9,6,9,20,45.0,11,18,0,18,4,26,6,0,Matches
463503e2,Marcin Kamiński,pl POL,DF,Schalke 04,31-078,1992,1.0,0,0,0,0,0,0,0,,0,2,2,0,3,3,5,0,Matches
b825a650,Kevin Kampl,si SVN,MF,RB Leipzig,32-176,1990,10.5,17,10,4,12,1,4,15,26.7,11,17,6,11,14,31,3,0,Matches
b4c816a9,Wilfried Kanga,ci CIV,FW,Hertha BSC,25-041,1998,14.2,5,4,2,1,2,2,3,66.7,1,12,3,9,0,5,12,0,Matches
8f0f2230,Kenan Karaman,tr TUR,FW,Schalke 04,29-029,1994,5.5,6,4,1,3,2,0,3,0.0,3,5,0,5,2,8,6,0,Matches
5762be5c,Atakan Karazor,de GER,MF,Stuttgart,26-172,1996,14.9,44,25,13,25,6,23,39,59.0,16,29,8,21,23,67,35,0,Matches
778ccc44,Thomas Kastanaras,gr GRE,"FW,DF",Stuttgart,20-084,2003,0.8,0,0,0,0,0,0,0,,0,1,0,1,0,0,0,0,Matches
de4cac2d,Silas Katompa,cd COD,"FW,DF",Stuttgart,24-179,1998,17.3,22,16,4,12,6,6,17,35.3,11,10,2,8,5,27,1,0,Matches
d2c580ce,Yannik Keitel,de GER,MF,Freiburg,23-047,2000,5.0,8,5,2,5,1,2,2,100.0,0,3,0,3,9,17,4,0,Matches
815c314f,Marc-Oliver Kempf,de GER,DF,Hertha BSC,28-065,1995,24.3,37,22,23,13,1,16,21,76.2,5,38,29,9,41,78,111,0,Matches
099e666f,Jonjoe Kenny,eng ENG,DF,Hertha BSC,26-019,1997,19.3,37,27,19,15,3,18,33,54.5,15,25,6,19,35,72,50,0,Matches
59e4b92e,Rani Khedira,de GER,MF,Union Berlin,29-066,1994,24.0,48,24,15,26,7,19,35,54.3,16,26,8,18,33,81,25,0,Matches
610aa1e9,Luca Kilian,de GER,DF,Köln,23-214,1999,12.2,22,16,14,7,1,12,21,57.1,9,16,8,8,10,32,48,0,Matches
49296448,Joshua Kimmich,de GER,MF,Bayern Munich,28-054,1995,23.6,64,38,17,39,8,33,60,55.0,27,21,2,19,34,98,28,0,Matches
ca8033cb,Lukas Klostermann,de GER,DF,RB Leipzig,26-304,1996,4.3,10,6,3,7,0,5,9,55.6,4,1,1,0,4,14,10,0,Matches
19a967ab,Ansgar Knauff,de GER,DF,Eint Frankfurt,21-083,2002,11.5,26,18,15,9,2,12,28,42.9,16,17,1,16,11,37,22,0,Matches
6bd5cd5d,Robin Knoche,de GER,DF,Union Berlin,30-316,1992,25.0,38,25,24,10,4,21,41,51.2,20,29,14,15,25,63,110,0,Matches
cd59b9df,Gregor Kobel,ch SUI,GK,Dortmund,25-118,1997,19.0,0,0,0,0,0,0,1,0.0,1,0,0,0,0,0,5,2,Matches
0fbecd11,Dominik Kohr,de GER,MF,Mainz 05,29-062,1994,18.8,43,25,13,25,5,20,46,43.5,26,31,7,24,28,71,19,0,Matches
c0b3669f,Randal Kolo Muani,fr FRA,FW,Eint Frankfurt,24-119,1998,22.8,12,9,3,2,7,1,7,14.3,6,16,1,15,2,14,8,0,Matches
ab096c6f,Timothée Kolodziejczak,fr FRA,DF,Schalke 04,31-184,1991,0.3,0,0,0,0,0,0,1,0.0,1,0,0,0,1,1,1,0,Matches
86574238,Kouadio Koné,fr FRA,MF,M'Gladbach,21-321,2001,24.3,64,34,33,27,4,22,38,57.9,16,33,7,26,25,89,16,0,Matches
1f3afdcb,Odilon Kossonou,ci CIV,DF,Leverkusen,22-089,2001,12.9,14,9,8,5,1,6,11,54.5,5,17,5,12,15,29,46,1,Matches
b1cd37e6,Filip Kostić,rs SRB,"DF,MF",Eint Frankfurt,30-153,1992,0.8,2,0,1,1,0,0,0,,0,0,0,0,1,3,0,0,Matches
dc366c36,Tomáš Koubek,cz CZE,GK,Augsburg,30-220,1992,4.0,0,0,0,0,0,0,0,,0,0,0,0,0,0,2,0,Matches
f1e855eb,Soichiro Kozuki,jp JPN,"FW,MF",Schalke 04,22-102,2000,4.2,6,4,3,3,0,4,6,66.7,2,5,0,5,3,9,3,0,Matches
e717705a,Alex Král,cz CZE,MF,Schalke 04,24-319,1998,18.2,29,19,9,18,2,14,29,48.3,15,27,4,23,14,43,38,0,Matches
603cb947,Andrej Kramarić,hr CRO,"MF,FW",Hoffenheim,31-288,1991,19.0,5,2,2,1,2,1,7,14.3,6,11,1,10,4,9,9,0,Matches
496aeede,Christoph Kramer,de GER,MF,M'Gladbach,32-043,1991,22.7,38,27,19,14,5,20,48,41.7,28,31,1,30,15,53,40,0,Matches
9f77012e,Tom Krauß,de GER,MF,Schalke 04,21-285,2001,23.5,99,58,36,53,10,42,86,48.8,44,33,4,29,31,130,22,0,Matches
f9446dcd,Max Kruse,de GER,"MF,FW",Wolfsburg,35-015,1988,3.0,1,1,0,1,0,0,1,0.0,1,2,1,1,0,1,1,0,Matches
2a29eb9b,Lukas Kübler,de GER,DF,Freiburg,30-216,1992,13.2,32,22,20,8,4,16,23,69.6,7,17,7,10,21,53,31,0,Matches
9ceb7642,Pierre Kunde,cm CMR,MF,Bochum,27-251,1995,3.6,10,5,2,8,0,4,12,33.3,8,6,1,5,4,14,7,0,Matches
f1bc3876,Alou Kuol,au AUS,FW,Stuttgart,22-188,2000,0.1,0,0,0,0,0,0,0,,0,0,0,0,0,0,0,0,Matches
2770726a,Daniel Kyereh,gh GHA,"MF,FW",Freiburg,27-026,1996,6.2,6,4,2,4,0,3,6,50.0,3,4,0,4,2,8,6,0,Matches
277c49ed,Maxence Lacroix,fr FRA,DF,Wolfsburg,22-362,2000,15.5,21,13,14,7,0,8,16,50.0,8,19,8,11,24,45,75,0,Matches
22798128,Aïssa Laïdouni,tn TUN,MF,Union Berlin,26-111,1996,5.3,9,3,3,6,0,3,10,30.0,7,15,3,12,5,14,3,0,Matches
c1b7847c,Konrad Laimer,at AUT,MF,RB Leipzig,25-311,1997,11.4,37,18,14,18,5,20,35,57.1,15,20,1,19,13,50,6,0,Matches
4aea5077,Stefan Lainer,at AUT,DF,M'Gladbach,30-219,1992,3.8,5,3,1,3,1,2,8,25.0,6,1,0,1,6,11,16,1,Matches
591477c9,Vassilis Lambropoulos,gr GRE,DF,Bochum,33-003,1990,6.9,10,8,7,3,0,6,9,66.7,3,5,3,2,12,22,40,0,Matches
72984eee,Jordan Larsson,se SWE,"FW,MF",Schalke 04,25-287,1997,5.1,8,5,1,7,0,2,9,22.2,7,9,0,9,4,12,3,0,Matches
33b554b7,Danny Latza,de GER,MF,Schalke 04,33-117,1989,5.1,10,8,5,4,1,4,8,50.0,4,11,0,11,1,11,7,0,Matches
c4987edc,Diogo Leite,pt POR,DF,Union Berlin,24-070,1999,20.3,27,15,16,11,0,16,28,57.1,12,19,12,7,23,50,77,0,Matches
7e12a98d,Maxim Leitsch,de GER,DF,Mainz 05,24-320,1998,7.4,9,7,6,3,0,4,5,80.0,1,7,4,3,18,27,26,1,Matches
792ffa71,Tim Lemperle,de GER,"FW,MF",Köln,21-057,2002,1.3,6,4,3,1,2,3,5,60.0,2,2,0,2,1,7,4,0,Matches
bbd86530,Christopher Lenz,de GER,DF,Eint Frankfurt,28-193,1994,8.4,19,15,9,6,4,11,23,47.8,12,12,1,11,11,30,22,0,Matches
13fe7b69,Jamie Leweling,de GER,FW,Union Berlin,22-036,2001,2.1,4,3,2,2,0,3,4,75.0,1,2,0,2,1,5,0,0,Matches
302527b2,Philipp Lienhart,at AUT,DF,Freiburg,26-266,1996,22.3,24,14,17,7,0,9,17,52.9,8,22,11,11,28,52,79,0,Matches
d6e53a3a,Matthijs de Ligt,nl NED,DF,Bayern Munich,23-234,1999,18.8,20,14,9,10,1,8,13,61.5,5,25,17,8,17,37,65,0,Matches
37dc1a48,Jesper Lindstrøm,dk DEN,"MF,FW",Eint Frankfurt,23-033,2000,17.0,23,10,13,6,4,6,20,30.0,14,21,2,19,7,30,9,0,Matches
c455a2b2,Dejan Ljubicic,at AUT,MF,Köln,25-177,1997,13.0,17,10,5,9,3,9,26,34.6,17,14,0,14,7,24,3,0,Matches
07c7eb0c,Anthony Losilla,fr FRA,MF,Bochum,37-024,1986,23.4,55,37,26,23,6,28,51,54.9,23,28,9,19,27,82,55,0,Matches
0c61c77c,Dodi Lukebakio,be BEL,"FW,MF",Hertha BSC,25-191,1997,20.1,16,10,6,8,2,6,19,31.6,13,20,5,15,8,24,12,0,Matches
8a6ab963,Andrey Lunyov,ru RUS,GK,Leverkusen,31-141,1991,1.0,0,0,0,0,0,0,0,,0,0,0,0,0,0,0,0,Matches
ab700320,Arne Maier,de GER,MF,Augsburg,24-085,1999,16.0,24,17,12,9,3,8,13,61.5,5,15,0,15,11,35,13,0,Matches
e5d85da8,Linton Maina,de GER,"FW,MF",Köln,23-284,1999,17.9,14,10,3,10,1,7,27,25.9,20,10,0,10,5,19,6,0,Matches
864163f3,Donyell Malen,nl NED,FW,Dortmund,24-074,1999,12.3,9,4,2,3,4,4,6,66.7,2,11,0,11,4,13,6,0,Matches
c691bfe2,Sadio Mané,sn SEN,FW,Bayern Munich,30-358,1992,12.2,8,3,2,2,4,1,8,12.5,7,14,2,12,0,8,2,0,Matches
706a60e1,Myziane Maolida,fr FRA,"FW,MF",Hertha BSC,24-048,1999,1.1,1,1,1,0,0,1,2,50.0,1,0,0,0,0,1,1,0,Matches
0e0102eb,Omar Marmoush,eg EGY,FW,Wolfsburg,24-055,1999,13.8,15,10,8,2,5,4,13,30.8,9,12,1,11,6,21,3,0,Matches
92a16062,Eric Martel,de GER,MF,Köln,20-339,2002,16.0,46,28,19,21,6,22,48,45.8,26,19,4,15,20,66,36,0,Matches
2f3e911a,Aarón Martín,es ESP,DF,Mainz 05,25-346,1997,16.6,32,22,19,9,4,16,25,64.0,9,14,1,13,13,45,24,0,Matches
a396fb61,Erhan Mašović,rs SRB,DF,Bochum,24-132,1998,16.5,40,27,22,18,0,23,39,59.0,16,22,11,11,17,57,58,0,Matches
ab3f1bdf,Henning Matriciani,de GER,DF,Schalke 04,23-020,2000,14.4,33,16,22,8,3,17,42,40.5,25,18,9,9,15,48,37,0,Matches
00963611,Konstantinos Mavropanos,gr GRE,DF,Stuttgart,25-113,1997,21.8,44,24,28,14,2,25,34,73.5,9,34,18,16,58,102,84,0,Matches
826e8b63,Philipp Max,de GER,DF,Eint Frankfurt,29-185,1993,6.2,10,7,4,5,1,4,12,33.3,8,8,1,7,1,11,6,0,Matches
0e6bc38c,Eric Maxim Choupo-Moting,cm CMR,FW,Bayern Munich,34-011,1989,12.1,10,7,2,6,2,1,2,50.0,1,8,0,8,0,10,5,0,Matches
b74277a0,Noussair Mazraoui,ma MAR,DF,Bayern Munich,25-140,1997,6.3,17,12,3,6,8,8,14,57.1,6,5,1,4,6,23,14,0,Matches
46750e9c,Nathanael Mbuku,fr FRA,FW,Augsburg,21-018,2002,0.2,0,0,0,0,0,0,0,,0,0,0,0,0,0,0,0,Matches
e162b013,Thomas Meunier,be BEL,DF,Dortmund,31-203,1991,6.5,16,7,8,5,3,10,17,58.8,7,7,2,5,9,25,16,0,Matches
b56dd813,Alexander Meyer,de GER,GK,Dortmund,31-355,1991,7.0,0,0,0,0,0,0,1,0.0,1,0,0,0,0,0,1,0,Matches
1e274a0a,Sven Michel,de GER,FW,Union Berlin,32-262,1990,4.6,7,4,1,5,1,4,6,66.7,2,3,1,2,0,7,4,0,Matches
f76022e7,Enzo Millot,fr FRA,MF,Stuttgart,20-260,2002,5.6,12,8,5,4,3,5,9,55.6,4,15,2,13,9,21,4,0,Matches
88d4144a,Maximilian Mittelstädt,de GER,DF,Hertha BSC,26-016,1997,7.1,32,15,24,6,2,13,26,50.0,13,10,1,9,20,52,24,0,Matches
34e4343c,Anthony Modeste,fr FRA,FW,Dortmund,34-354,1988,8.9,4,4,2,0,2,2,5,40.0,3,6,0,6,2,6,21,0,Matches
9ec9c8b6,Tobias Mohr,de GER,"DF,MF",Schalke 04,27-222,1995,8.8,7,4,3,4,0,2,7,28.6,5,13,5,8,8,15,19,0,Matches
29ddfb9c,Clinton Mola,eng ENG,DF,Stuttgart,22-019,2001,0.2,3,1,2,1,0,1,1,100.0,0,1,1,0,1,4,2,0,Matches
7e82a78f,Florent Mollet,fr FRA,MF,Schalke 04,31-135,1991,4.6,4,1,0,4,0,2,7,28.6,5,7,1,6,1,5,1,0,Matches
6ce43701,Youssoufa Moukoko,de GER,FW,Dortmund,18-134,2004,10.9,13,7,3,6,4,3,6,50.0,3,6,0,6,1,14,1,0,Matches
cbac6ec9,Florian Müller,de GER,GK,Stuttgart,25-141,1997,19.0,0,0,0,0,0,0,0,,0,0,0,0,0,0,7,4,Matches
3c6089ab,Thomas Müller,de GER,"FW,MF",Bayern Munich,33-202,1989,12.5,14,8,3,7,4,4,9,44.4,5,8,2,6,3,17,7,0,Matches
2c0558b8,Jamal Musiala,de GER,"MF,FW",Bayern Munich,20-036,2003,18.8,28,20,8,14,6,10,23,43.5,13,19,1,18,15,43,3,0,Matches
9ff8ec4a,Suliman Mustapha,at AUT,"FW,MF",Mainz 05,21-314,2001,0.8,2,2,0,2,0,0,0,,0,4,0,4,0,2,0,0,Matches
441197b8,Obite N'Dicka,fr FRA,DF,Eint Frankfurt,23-226,1999,24.9,21,15,9,8,4,15,27,55.6,12,39,15,24,29,50,133,0,Matches
e110ea4b,Nathan N'Goumou,fr FRA,FW,M'Gladbach,23-020,2000,3.7,7,3,4,2,1,4,8,50.0,4,5,0,5,0,7,3,0,Matches
61590953,Stanley N'Soki,fr FRA,DF,Hoffenheim,23-359,1999,12.2,20,11,13,6,1,10,19,52.6,9,17,4,13,21,41,31,0,Matches
30261ba1,Nikolas Nartey,dk DEN,"DF,MF",Stuttgart,23-040,2000,4.3,9,4,6,2,1,4,8,50.0,4,8,0,8,3,12,11,0,Matches
e79269bd,Luca Netz,de GER,DF,M'Gladbach,19-323,2003,4.6,16,7,12,2,2,12,19,63.2,7,3,1,2,3,19,21,0,Matches
8778c910,Manuel Neuer,de GER,GK,Bayern Munich,37-007,1986,12.0,0,0,0,0,0,0,0,,0,0,0,0,0,0,4,1,Matches
36a59ba4,Florian Neuhaus,de GER,MF,M'Gladbach,26-018,1997,9.5,9,5,4,3,2,2,9,22.2,7,17,3,14,7,16,3,0,Matches
bc249af8,Jessic Ngankam,de GER,"FW,MF",Hertha BSC,22-257,2000,5.8,10,6,5,2,3,3,5,60.0,2,6,1,5,0,10,1,0,Matches
d6862409,Florian Niederlechner,de GER,"FW,MF",Augsburg,32-161,1990,10.1,10,5,5,4,1,4,7,57.1,3,16,2,14,1,11,9,0,Matches
d6862409,Florian Niederlechner,de GER,FW,Hertha BSC,32-161,1990,5.5,6,5,1,2,3,2,5,40.0,3,7,0,7,1,7,8,0,Matches
a45241d5,Justin Njinmah,de GER,FW,Dortmund,22-139,2000,0.2,0,0,0,0,0,0,0,,0,0,0,0,0,0,0,0,Matches
7c56da38,Christopher Nkunku,fr FRA,"FW,MF",RB Leipzig,25-140,1997,15.8,3,2,0,1,2,1,5,20.0,4,7,3,4,7,10,8,0,Matches
091c86e2,Felix Nmecha,de GER,MF,Wolfsburg,22-175,2000,12.9,24,13,5,13,6,10,17,58.8,7,15,6,9,15,39,21,0,Matches
0cc5f4a5,Lukas Nmecha,de GER,FW,Wolfsburg,24-110,1998,10.0,5,3,0,2,3,3,3,100.0,0,5,1,4,3,8,4,0,Matches
5458f670,Hugo Novoa,es ESP,"DF,FW",RB Leipzig,20-092,2003,2.0,8,2,1,3,4,4,7,57.1,3,4,0,4,1,9,0,0,Matches
bdedffac,Ørjan Nyland,no NOR,GK,RB Leipzig,32-205,1990,1.0,0,0,0,0,0,0,0,,0,0,0,0,0,0,0,0,Matches
57ec75bf,Tim Oermann,de GER,DF,Bochum,19-179,2003,2.2,2,1,2,0,0,1,1,100.0,0,3,2,1,1,3,8,1,Matches
dd2e62da,Finn Ole Becker,de GER,MF,Hoffenheim,22-299,2000,2.2,6,2,1,5,0,1,2,50.0,1,4,0,4,2,8,1,0,Matches
86adbcc7,Mathias Olesen,lu LUX,MF,Köln,22-013,2001,4.9,10,5,4,4,2,5,7,71.4,2,5,1,4,2,12,3,0,Matches
ae44e8e2,Dani Olmo,es ESP,"MF,FW",RB Leipzig,24-331,1998,9.0,11,7,1,7,3,5,8,62.5,3,9,0,9,6,17,3,0,Matches
c631f952,Jonas Omlin,ch SUI,GK,M'Gladbach,29-083,1994,8.3,0,0,0,0,0,0,1,0.0,1,1,0,1,0,0,5,0,Matches
f26834c7,Karim Onisiwo,at AUT,"FW,MF",Mainz 05,31-017,1992,21.1,14,8,1,7,6,3,13,23.1,10,14,0,14,2,16,6,0,Matches
20030c06,Willi Orban,hu HUN,DF,RB Leipzig,30-151,1992,24.8,39,28,24,15,0,21,34,61.8,13,31,19,12,33,72,101,1,Matches
86c75897,Ivan Ordets,ua UKR,DF,Bochum,30-269,1992,19.2,26,15,19,6,1,15,24,62.5,9,24,10,14,35,61,89,0,Matches
0a16eb36,Jordi Osei-Tutu,eng ENG,"DF,FW",Bochum,24-183,1998,7.2,20,15,11,5,4,9,15,60.0,6,12,5,7,9,29,7,0,Matches
9662c9ec,Patrick Osterhage,de GER,MF,Bochum,23-061,2000,8.1,17,15,6,9,2,10,14,71.4,4,12,4,8,10,27,19,0,Matches
1cbe4984,Paulo Otávio,br BRA,DF,Wolfsburg,28-131,1994,21.1,64,39,42,14,8,39,56,69.6,17,39,5,34,29,93,66,1,Matches
36d9dabe,Thomas Ouwejan,nl NED,DF,Schalke 04,26-185,1996,9.0,19,8,13,5,1,6,10,60.0,4,17,4,13,13,32,24,0,Matches
8b6e0db2,Reece Oxford,eng ENG,DF,Augsburg,24-108,1998,1.0,1,1,1,0,0,0,0,,0,4,3,1,1,2,5,0,Matches
15413fa5,Salih Özcan,tr TUR,MF,Dortmund,25-082,1998,15.4,26,15,7,15,4,14,36,38.9,22,20,2,18,24,50,16,1,Matches
66385c46,Levin Öztunalı,de GER,MF,Union Berlin,27-019,1996,0.1,0,0,0,0,0,0,1,0.0,1,0,0,0,0,0,0,0,Matches
e82adcab,Exequiel Palacios,ar ARG,MF,Leverkusen,24-180,1998,14.0,44,27,16,25,3,23,41,56.1,18,19,2,17,29,73,23,0,Matches
5dc15574,Miloš Pantović,rs SRB,MF,Union Berlin,26-270,1996,2.0,3,1,3,0,0,3,4,75.0,1,2,0,2,0,3,4,0,Matches
13d23b29,Antonios Papadopoulos,de GER,DF,Dortmund,23-205,1999,0.1,0,0,0,0,0,0,0,,0,0,0,0,1,1,0,0,Matches
5c50fdbc,Kevin Paredes,us USA,"FW,MF",Wolfsburg,19-331,2003,4.4,10,7,3,3,4,7,9,77.8,2,4,0,4,5,15,5,0,Matches
1866b0f1,Marco Pašalić,hr CRO,MF,Dortmund,22-201,2000,0.1,0,0,0,0,0,0,0,,0,0,0,0,0,0,0,0,Matches
5c899683,Felix Passlack,de GER,DF,Dortmund,24-309,1998,0.5,1,0,0,1,0,0,0,,0,0,0,0,0,1,0,0,Matches
53070b63,Paulinho,br BRA,FW,Leverkusen,22-262,2000,0.9,0,0,0,0,0,0,0,,0,1,0,1,0,0,2,0,Matches
45a03961,Benjamin Pavard,fr FRA,DF,Bayern Munich,27-006,1996,20.0,54,34,27,19,8,26,32,81.3,6,25,11,14,33,87,57,0,Matches
0a1cb833,Jiří Pavlenka,cz CZE,GK,Werder Bremen,30-354,1992,24.3,1,0,1,0,0,1,5,20.0,4,0,0,0,3,4,16,1,Matches
5154b2ba,Kristian Pedersen,dk DEN,DF,Köln,28-242,1994,3.0,5,4,4,1,0,0,2,0.0,2,3,0,3,5,10,17,0,Matches
582a5247,Mads Pedersen,dk DEN,"DF,MF",Augsburg,26-214,1996,14.1,35,17,25,8,2,17,24,70.8,7,23,7,16,18,53,33,1,Matches
b684a484,Jordan Pefok,us USA,FW,Union Berlin,26-342,1996,13.0,14,7,3,3,8,2,15,13.3,13,17,5,12,4,18,13,0,Matches
c18d22f5,Peter Pekarík,sk SVK,DF,Hertha BSC,36-155,1986,1.0,3,3,3,0,0,3,4,75.0,1,6,2,4,1,4,3,0,Matches
3b61c9ec,Luca Pellegrini,it ITA,DF,Eint Frankfurt,24-027,1999,6.2,13,8,10,3,0,8,8,100.0,0,8,2,6,7,20,11,1,Matches
a2b1ed42,Ricardo Pepi,us USA,FW,Augsburg,20-084,2003,1.1,1,1,1,0,0,1,1,100.0,0,1,0,1,0,1,1,0,Matches
ff3d391c,Juan Perea,co COL,FW,Stuttgart,23-039,2000,4.4,5,4,0,2,3,2,4,50.0,2,2,1,1,1,6,3,0,Matches
f93e6e94,Nils Petersen,de GER,FW,Freiburg,34-118,1988,2.5,6,4,0,3,3,2,5,40.0,3,10,2,8,1,7,6,0,Matches
f503ef6e,Lukas Petkov,de GER,"MF,FW",Augsburg,22-153,2000,1.6,5,1,4,1,0,2,3,66.7,1,4,1,3,1,6,0,0,Matches
83e1f40e,Luca Pfeiffer,de GER,FW,Stuttgart,26-226,1996,7.4,1,1,1,0,0,0,1,0.0,1,3,0,3,1,2,5,0,Matches
061e8e23,Maximilian Philipp,de GER,FW,Wolfsburg,29-033,1994,1.3,2,1,1,1,0,1,1,100.0,0,1,0,1,0,2,0,0,Matches
061e8e23,Maximilian Philipp,de GER,"MF,FW",Werder Bremen,29-033,1994,1.2,2,1,2,0,0,0,2,0.0,2,3,1,2,3,5,1,0,Matches
526ea7cc,Amos Pieper,de GER,DF,Werder Bremen,25-076,1998,20.7,43,26,22,19,2,22,36,61.1,14,21,11,10,27,70,87,1,Matches
f7aa75bd,Marvin Plattenhardt,de GER,DF,Hertha BSC,31-067,1992,20.3,33,25,20,10,3,23,36,63.9,13,21,7,14,11,44,55,0,Matches
bc6bd723,Alassane Pléa,fr FRA,FW,M'Gladbach,30-024,1993,15.6,14,7,4,7,3,6,17,35.3,11,19,2,17,10,24,13,0,Matches
ea003d07,Joel Pohjanpalo,fi FIN,"FW,MF",Leverkusen,28-202,1994,0.0,0,0,0,0,0,0,0,,0,0,0,0,0,0,0,0,Matches
3745e8bd,Sebastian Polter,de GER,"FW,MF",Schalke 04,32-002,1991,5.2,4,3,0,4,0,1,3,33.3,2,3,0,3,0,4,6,0,Matches
7f609bfc,Stefan Posch,at AUT,DF,Hoffenheim,25-324,1997,0.2,0,0,0,0,0,0,0,,0,0,0,0,0,0,0,0,Matches
d2416c2e,Yussuf Poulsen,dk DEN,FW,RB Leipzig,28-292,1994,3.9,4,3,1,2,1,0,3,0.0,3,3,1,2,0,4,5,0,Matches
924f9191,Grischa Prömel,de GER,MF,Hoffenheim,28-084,1995,11.9,23,18,12,9,2,7,18,38.9,11,16,3,13,5,28,17,0,Matches
c68b1b13,Tymoteusz Puchacz,pl POL,DF,Union Berlin,24-070,1999,0.6,1,0,1,0,0,0,0,,0,0,0,0,0,1,1,0,Matches
3c200e05,Joshua Quarshie,de GER,MF,Hoffenheim,18-251,2004,0.0,0,0,0,0,0,0,0,,0,0,0,0,0,0,0,0,Matches
b90c4a43,Diant Ramaj,de GER,GK,Eint Frankfurt,21-196,2001,1.0,0,0,0,0,0,0,0,,0,0,0,0,0,0,1,0,Matches
c8b3a472,Nicolai Rapp,de GER,"MF,DF",Werder Bremen,26-111,1996,0.8,3,1,3,0,0,0,3,0.0,3,0,0,0,0,3,1,0,Matches
7d450ed3,David Raum,de GER,"DF,FW",RB Leipzig,24-346,1998,15.9,33,21,20,9,4,12,21,57.1,9,20,5,15,15,48,20,1,Matches
cc971106,Rocco Reitz,de GER,MF,M'Gladbach,20-309,2002,0.0,0,0,0,0,0,0,0,,0,0,0,0,0,0,0,0,Matches
36a3ff67,Marco Reus,de GER,"MF,FW",Dortmund,33-307,1989,12.8,24,14,9,13,2,5,20,25.0,15,10,4,6,5,29,7,0,Matches
1ae836b1,Elvis Rexhbeçaj,de GER,MF,Augsburg,25-153,1997,21.0,38,24,12,18,8,21,46,45.7,25,29,10,19,13,51,33,0,Matches
7fa4e703,Gio Reyna,us USA,"FW,MF",Dortmund,20-141,2002,5.9,11,5,2,5,4,4,9,44.4,5,7,2,5,3,14,4,0,Matches
f972644c,Marco Richter,de GER,"FW,MF",Hertha BSC,25-130,1997,14.8,36,17,15,14,7,19,39,48.7,20,23,0,23,16,52,19,0,Matches
9f941969,Manuel Riemann,de GER,GK,Bochum,34-206,1988,26.0,2,1,2,0,0,2,2,100.0,0,1,0,1,5,7,17,4,Matches
e12b0b5b,Sebastian Rode,de GER,MF,Eint Frankfurt,32-174,1990,11.3,28,18,5,20,3,10,31,32.3,21,12,1,11,10,38,10,0,Matches
ea42c03f,Agustín Rogel,uy URU,DF,Hertha BSC,25-168,1997,12.3,17,9,12,5,0,10,14,71.4,4,11,4,7,11,28,43,0,Matches
1f2c7b55,Merlin Röhl,de GER,MF,Freiburg,20-272,2002,0.1,0,0,0,0,0,0,0,,0,0,0,0,0,0,1,0,Matches
90c1f9a4,Tom Rothe,de GER,DF,Dortmund,18-156,2004,0.3,1,1,0,1,0,1,1,100.0,0,0,0,0,1,2,2,0,Matches
13203c45,Jérôme Roussillon,fr FRA,"MF,DF",Wolfsburg,30-087,1993,0.2,0,0,0,0,0,0,0,,0,0,0,0,0,0,0,0,Matches
13203c45,Jérôme Roussillon,fr FRA,DF,Union Berlin,30-087,1993,4.0,5,2,3,1,1,4,5,80.0,1,3,2,1,1,6,9,0,Matches
80f36c88,Sebastian Rudy,de GER,MF,Hoffenheim,33-034,1990,6.0,18,10,7,11,0,7,19,36.8,12,16,1,15,6,24,12,0,Matches
c64c01fc,Georginio Rutter,fr FRA,FW,Hoffenheim,20-348,2002,11.2,7,4,1,4,2,1,3,33.3,2,10,2,8,5,12,6,0,Matches
009a4f60,Julian Ryerson,no NOR,DF,Union Berlin,25-137,1997,11.5,28,17,17,10,1,15,25,60.0,10,15,3,12,12,40,19,0,Matches
009a4f60,Julian Ryerson,no NOR,DF,Dortmund,25-137,1997,8.3,13,5,9,3,1,11,15,73.3,4,7,1,6,6,19,12,0,Matches
a70b8345,Frederik Rønnow,dk DEN,GK,Union Berlin,30-242,1992,21.0,0,0,0,0,0,0,3,0.0,3,0,0,0,0,0,7,0,Matches
e280527c,Marcel Sabitzer,at AUT,MF,Bayern Munich,29-017,1994,7.0,27,14,11,10,6,10,17,58.8,7,3,0,3,10,37,9,0,Matches
e1830c52,Dikeni Salifou,tg TOG,MF,Werder Bremen,19-299,2003,0.0,0,0,0,0,0,0,0,,0,0,0,0,0,0,0,0,Matches
bf075f6b,Roland Sallai,hu HUN,"MF,FW",Freiburg,25-316,1997,7.0,5,5,1,3,1,2,8,25.0,6,6,1,5,2,7,4,0,Matches
08593525,Diadie Samassékou,ml MLI,"MF,FW",Hoffenheim,27-082,1996,0.4,1,0,0,1,0,0,1,0.0,1,0,0,0,0,1,0,0,Matches
2b114be3,Leroy Sané,de GER,"MF,FW",Bayern Munich,27-082,1996,17.5,30,23,8,15,7,13,24,54.2,11,9,1,8,2,32,1,2,Matches
6a52a6c6,Sidi Sané,de GER,FW,Schalke 04,19-347,2003,0.3,1,1,1,0,0,1,1,100.0,0,0,0,0,0,1,0,0,Matches
236f02cd,Joe Scally,us USA,DF,M'Gladbach,20-093,2002,21.9,28,17,23,5,0,22,28,78.6,6,15,6,9,8,36,54,0,Matches
52afb588,Kevin Schade,de GER,"FW,MF",Freiburg,21-127,2001,2.0,6,4,3,2,1,3,5,60.0,2,0,0,0,0,6,2,0,Matches
049751d7,András Schäfer,hu HUN,MF,Union Berlin,23-355,1999,8.4,20,8,7,12,1,6,13,46.2,7,11,2,9,4,24,11,0,Matches
93cba339,Derry Scherhant,de GER,FW,Hertha BSC,20-144,2002,2.1,4,3,2,2,0,2,3,66.7,1,1,0,1,0,4,3,0,Matches
5d4f7d61,Patrik Schick,cz CZE,FW,Leverkusen,27-069,1996,10.5,0,0,0,0,0,0,1,0.0,1,4,1,3,1,1,7,0,Matches
bd527260,Kingsley Schindler,gh GHA,"DF,MF",Köln,29-265,1993,8.5,18,11,12,5,1,14,22,63.6,8,7,1,6,10,28,19,0,Matches
8f056768,Xaver Schlager,at AUT,MF,RB Leipzig,25-187,1997,16.3,40,23,13,25,2,20,43,46.5,23,19,2,17,16,56,23,0,Matches
f6bdc830,Keven Schlotterbeck,de GER,DF,Freiburg,25-340,1997,0.2,0,0,0,0,0,0,0,,0,1,1,0,2,2,2,0,Matches
f6bdc830,Keven Schlotterbeck,de GER,DF,Bochum,25-340,1997,6.5,14,6,10,4,0,7,8,87.5,1,11,5,6,13,27,36,0,Matches
34e12499,Nico Schlotterbeck,de GER,DF,Dortmund,23-123,1999,24.7,57,33,34,22,1,36,52,69.2,16,38,21,17,31,88,71,1,Matches
088ca1bd,Jonathan Schmid,fr FRA,DF,Freiburg,32-285,1990,0.4,0,0,0,0,0,0,0,,0,1,0,1,0,0,0,1,Matches
220ace7e,Romano Schmid,at AUT,MF,Werder Bremen,23-066,2000,12.8,23,14,5,12,6,10,19,52.6,9,18,3,15,6,29,10,0,Matches
7d31f1cb,Kenneth Schmidt,de GER,DF,Freiburg,20-304,2002,0.7,1,0,0,1,0,0,0,,0,0,0,0,0,1,1,0,Matches
b9ae8560,Niklas Schmidt,de GER,MF,Werder Bremen,25-033,1998,10.8,23,10,11,10,2,11,25,44.0,14,9,0,9,5,28,9,0,Matches
ad00b1a8,Benno Schmitz,de GER,DF,Köln,28-137,1994,21.2,55,36,24,26,5,35,61,57.4,26,28,4,24,22,77,43,0,Matches
87436846,Marvin Schwäbe,de GER,GK,Köln,27-343,1995,26.0,1,0,1,0,0,1,1,100.0,0,0,0,0,2,3,5,2,Matches
0d55d942,Alexander Schwolow,de GER,GK,Schalke 04,30-305,1992,17.0,0,0,0,0,0,0,0,,0,0,0,0,1,1,6,2,Matches
8872ed17,Paul Seguin,de GER,MF,Union Berlin,28-005,1995,7.0,14,7,7,3,4,6,16,37.5,10,6,0,6,5,19,7,0,Matches
1238a3f9,Davie Selke,de GER,FW,Hertha BSC,28-073,1995,3.1,2,1,1,1,0,0,1,0.0,1,3,1,2,1,3,5,0,Matches
1238a3f9,Davie Selke,de GER,FW,Köln,28-073,1995,4.7,0,0,0,0,0,0,2,0.0,2,2,0,2,0,0,4,0,Matches
b3325a30,Suat Serdar,de GER,MF,Hertha BSC,25-357,1997,19.0,45,19,12,26,7,18,34,52.9,16,46,12,34,25,70,21,0,Matches
313254a3,Kiliann Sildillia,fr FRA,"DF,MF",Freiburg,20-322,2002,20.3,32,20,9,19,4,17,25,68.0,8,22,8,14,21,53,39,1,Matches
3effaa34,André Silva,pt POR,FW,RB Leipzig,27-148,1995,17.7,10,4,2,4,4,3,7,42.9,4,11,1,10,2,12,3,0,Matches
fcb27134,Mohamed Simakan,fr FRA,DF,RB Leipzig,22-335,2000,10.4,12,10,8,3,1,8,13,61.5,5,14,2,12,10,22,37,0,Matches
7ec723b7,Eduardo Simões,pt POR,DF,Hoffenheim,21-032,2002,1.0,5,3,3,2,0,1,3,33.3,2,3,2,1,0,5,3,0,Matches
73000a79,Daley Sinkgraven,nl NED,"DF,MF",Leverkusen,27-273,1995,3.7,9,7,7,2,0,6,7,85.7,1,8,4,4,5,14,7,0,Matches
0d8a37c2,Tobias Sippel,de GER,GK,M'Gladbach,35-012,1988,5.7,0,0,0,0,0,0,0,,0,0,0,0,0,0,1,1,Matches
c6cf860f,Hugo Siquet,be BEL,DF,Freiburg,20-268,2002,0.2,2,2,2,0,0,2,2,100.0,0,1,0,1,0,2,0,0,Matches
65857fdf,Tim Skarke,de GER,"DF,MF",Union Berlin,26-208,1996,0.6,1,1,0,0,1,0,0,,0,1,0,1,0,1,0,0,Matches
65857fdf,Tim Skarke,de GER,"FW,MF",Schalke 04,26-208,1996,2.6,6,2,1,4,1,3,6,50.0,3,4,0,4,0,6,1,0,Matches
c2211709,Ellyes Skhiri,tn TUN,MF,Köln,27-328,1995,24.7,70,39,24,39,7,24,57,42.1,33,39,9,30,46,116,40,0,Matches
ff98492b,Robert Skov,dk DEN,DF,Hoffenheim,26-318,1996,13.7,17,9,11,5,1,7,22,31.8,15,20,6,14,8,25,18,1,Matches
c967f6b8,Hrvoje Smolčić,hr CRO,DF,Eint Frankfurt,22-229,2000,5.2,8,7,6,2,0,5,10,50.0,5,11,4,7,6,14,38,0,Matches
c05f2f8c,Danilo Soares,br BRA,DF,Bochum,31-156,1991,15.2,56,38,30,19,7,34,52,65.4,18,25,4,21,22,78,39,1,Matches
4f627629,Nikola Soldo,hr CRO,DF,Köln,22-068,2001,6.6,15,9,8,7,0,7,11,63.6,4,7,6,1,7,22,28,0,Matches
420c18a1,Yann Sommer,ch SUI,GK,Bayern Munich,34-107,1988,11.0,0,0,0,0,0,0,0,,0,0,0,0,1,1,4,0,Matches
420c18a1,Yann Sommer,ch SUI,GK,M'Gladbach,34-107,1988,10.0,1,0,1,0,0,1,1,100.0,0,0,0,0,0,1,8,0,Matches
af0d79a9,Borna Sosa,hr CRO,DF,Stuttgart,25-072,1998,15.0,21,15,14,6,1,17,25,68.0,8,12,3,9,15,36,29,0,Matches
4c6facae,Djibril Sow,ch SUI,MF,Eint Frankfurt,26-056,1997,22.7,36,20,11,23,2,17,34,50.0,17,20,4,16,27,63,19,0,Matches
0f59a7bf,Anton Stach,de GER,MF,Mainz 05,24-139,1998,17.7,24,18,10,12,2,13,29,44.8,16,24,2,22,32,56,24,0,Matches
861e0116,Kostas Stafylidis,gr GRE,"DF,MF",Bochum,29-122,1993,9.9,26,15,12,8,6,9,19,47.4,10,19,8,11,14,40,26,1,Matches
1fffae99,Jens Stage,dk DEN,MF,Werder Bremen,26-146,1996,13.8,27,13,10,16,1,6,28,21.4,22,28,8,20,13,40,19,0,Matches
7ed08d5c,Josip Stanišić,hr CRO,DF,Bayern Munich,23-001,2000,5.2,19,11,14,2,3,12,17,70.6,5,6,0,6,6,25,9,1,Matches
aad48be9,Niklas Stark,de GER,DF,Werder Bremen,27-354,1995,15.4,39,28,20,16,3,18,27,66.7,9,10,4,6,27,66,71,0,Matches
99f7e9aa,Pascal Stenzel,de GER,DF,Stuttgart,27-014,1996,3.6,12,8,8,4,0,5,9,55.6,4,8,2,6,5,17,6,0,Matches
3b1ed320,Angelo Stiller,de GER,MF,Hoffenheim,21-364,2001,6.8,24,10,8,12,4,6,9,66.7,3,11,2,9,9,33,6,0,Matches
7cd6badb,Lars Stindl,de GER,"FW,MF",M'Gladbach,34-220,1988,15.1,19,10,4,13,2,10,23,43.5,13,19,3,16,10,29,17,0,Matches
e5649a78,Kevin Stöger,at AUT,MF,Bochum,29-219,1993,22.4,62,32,28,25,9,21,63,33.3,42,21,4,17,22,84,18,0,Matches
e33c06cf,Niklas Süle,de GER,DF,Dortmund,27-212,1995,16.8,16,12,12,2,2,7,13,53.8,6,22,13,9,12,28,37,0,Matches
e18098de,Ivan Šunjić,hr CRO,MF,Hertha BSC,26-176,1996,11.0,38,20,16,21,1,16,24,66.7,8,17,5,12,13,51,19,1,Matches
92d83c27,Mattias Svanberg,se SWE,MF,Wolfsburg,24-088,1999,14.8,13,8,5,8,0,6,19,31.6,13,19,4,15,15,28,19,1,Matches
934e1968,Dominik Szoboszlai,hu HUN,"MF,FW",RB Leipzig,22-160,2000,21.0,34,22,8,15,11,12,29,41.4,17,28,2,26,16,50,24,0,Matches
e92cd3f7,Alexander Sørloth,no NOR,FW,RB Leipzig,27-119,1995,0.1,0,0,0,0,0,0,0,,0,0,0,0,0,0,0,0,Matches
bd142efb,Jonathan Tah,de GER,DF,Leverkusen,27-051,1996,20.6,20,10,16,4,0,11,16,68.8,5,21,13,8,26,46,92,0,Matches
a73c8f95,Edmond Tapsoba,bf BFA,DF,Leverkusen,24-060,1999,24.9,40,23,28,9,3,24,35,68.6,11,31,16,15,29,69,86,1,Matches
27270af4,Niklas Tauer,de GER,"DF,MF",Mainz 05,22-045,2001,1.0,2,1,2,0,0,1,3,33.3,2,2,1,1,2,4,4,0,Matches
829aa60c,Mathys Tel,fr FRA,FW,Bayern Munich,17-341,2005,3.5,1,1,0,1,0,1,1,100.0,0,5,1,4,0,1,1,0,Matches
0b45a8d7,Semir Telalovic,de GER,"MF,FW",M'Gladbach,23-101,1999,0.1,0,0,0,0,0,0,0,,0,0,0,0,0,0,0,0,Matches
863ff1ee,Simon Terodde,de GER,FW,Schalke 04,35-032,1988,15.6,14,7,4,6,4,2,10,20.0,8,6,2,4,6,20,6,0,Matches
ff5ea0bf,Malick Thiaw,de GER,DF,Schalke 04,21-238,2001,3.0,3,1,2,1,0,1,2,50.0,1,4,3,1,9,12,24,1,Matches
fd53759d,Jan Thielmann,de GER,FW,Köln,20-312,2002,6.3,8,7,3,4,1,2,8,25.0,6,9,2,7,5,13,5,0,Matches
d1b49282,Morten Thorsby,no NOR,MF,Union Berlin,26-333,1996,7.3,16,8,6,9,1,10,16,62.5,6,9,4,5,2,18,18,0,Matches
6f8cd6d0,Marcus Thuram,fr FRA,FW,M'Gladbach,25-240,1997,23.2,13,6,3,5,5,6,10,60.0,4,15,3,12,5,18,17,0,Matches
6b8887c2,Steffen Tigges,de GER,FW,Köln,24-246,1998,15.0,8,5,1,6,1,4,12,33.3,8,11,2,9,7,15,15,0,Matches
e547d3cf,Umut Tohumcu,de GER,MF,Hoffenheim,18-235,2004,2.6,10,5,4,5,1,3,7,42.9,4,3,0,3,0,10,4,0,Matches
b492126a,Tiago Tomás,pt POR,"FW,MF",Stuttgart,20-291,2002,11.3,8,4,2,3,3,6,9,66.7,3,8,2,6,1,9,3,0,Matches
c8c60119,Almamy Touré,ml MLI,DF,Eint Frankfurt,26-340,1996,1.8,5,4,2,3,0,3,5,60.0,2,5,2,3,5,10,2,0,Matches
71ec39ef,Lucas Tousart,fr FRA,MF,Hertha BSC,25-339,1997,24.7,58,29,26,24,8,18,40,45.0,22,23,1,22,37,95,53,1,Matches
ce17b5eb,Kevin Trapp,de GER,GK,Eint Frankfurt,32-269,1990,25.0,1,1,1,0,0,0,1,0.0,1,2,0,2,0,1,9,0,Matches
056d2d95,Christopher Trimmel,at AUT,DF,Union Berlin,36-038,1987,17.3,28,15,15,11,2,18,27,66.7,9,13,1,12,23,51,42,0,Matches
35d64857,Tuta,br BRA,DF,Eint Frankfurt,23-273,1999,23.9,36,23,18,13,5,22,39,56.4,17,36,11,25,34,70,102,1,Matches
7d3e7da6,Sven Ulreich,de GER,GK,Bayern Munich,34-243,1988,3.0,1,1,1,0,0,1,1,100.0,0,0,0,0,0,1,0,1,Matches
cd61c7af,Lauren Ulrich,de GER,MF,Stuttgart,18-062,2005,0.1,1,1,0,0,1,0,0,,0,0,0,0,0,1,0,0,Matches
d248cd8f,Dayot Upamecano,fr FRA,DF,Bayern Munich,24-158,1998,23.0,60,34,39,21,0,26,41,63.4,15,24,6,18,25,85,67,4,Matches
af842091,Filip Uremović,hr CRO,DF,Hertha BSC,26-051,1997,15.2,25,14,17,7,1,10,16,62.5,6,13,10,3,26,51,68,2,Matches
d75f3980,Jere Uronen,fi FIN,DF,Schalke 04,28-264,1994,4.7,6,4,3,3,0,2,5,40.0,3,4,2,2,4,10,6,0,Matches
a3ddb1b9,Mark Uth,de GER,"MF,FW",Köln,31-222,1991,0.5,0,0,0,0,0,0,0,,0,0,0,0,0,0,0,0,Matches
fb377d11,Josha Vagnoman,de GER,"DF,MF",Stuttgart,22-113,2000,8.7,12,7,5,5,2,7,9,77.8,2,12,2,10,6,18,20,0,Matches
6ecbddf6,Ruben Vargas,ch SUI,"MF,FW",Augsburg,24-241,1998,8.6,11,5,5,4,2,3,9,33.3,6,6,2,4,4,15,13,1,Matches
fc8fcbd1,Renato Veiga,pt POR,DF,Augsburg,19-248,2003,3.7,4,3,1,1,2,3,3,100.0,0,7,4,3,3,7,18,1,Matches
a5ae8f8e,Miloš Veljković,rs SRB,DF,Werder Bremen,27-189,1995,17.9,23,13,14,9,0,14,23,60.9,9,24,13,11,27,50,78,0,Matches
8fe2a392,Mickey van de Ven,nl NED,DF,Wolfsburg,21-349,2001,26.0,35,23,19,16,0,24,32,75.0,8,33,20,13,20,55,91,2,Matches
5360a956,Gabriel Vidovic,hr CRO,FW,Bayern Munich,19-123,2003,0.2,0,0,0,0,0,0,0,,0,0,0,0,0,0,0,0,Matches
1d8e9add,Kevin Vogt,de GER,DF,Hoffenheim,31-192,1991,18.2,15,10,9,6,0,9,21,42.9,12,18,11,7,23,38,65,0,Matches
f86cd5df,Aster Vranckx,be BEL,MF,Wolfsburg,20-181,2002,0.1,0,0,0,0,0,0,0,,0,0,0,0,0,0,1,0,Matches
e3d3fbeb,Robert Wagner,de GER,MF,Freiburg,19-263,2003,0.3,0,0,0,0,0,0,0,,0,2,0,2,0,0,2,0,Matches
e5a35ae9,Luca Waldschmidt,de GER,FW,Wolfsburg,26-319,1996,4.2,5,2,2,1,2,2,7,28.6,5,1,0,1,2,7,3,0,Matches
cb64672e,Paul Wanner,de GER,MF,Bayern Munich,17-101,2005,0.3,3,1,1,2,0,1,1,100.0,0,0,0,0,0,3,1,0,Matches
346d51d9,Julian Weigl,de GER,MF,M'Gladbach,27-207,1995,14.0,29,12,14,14,1,16,29,55.2,13,14,1,13,12,41,21,0,Matches
231c67ff,Nelson Weiper,de GER,"FW,MF",Mainz 05,18-017,2005,0.4,2,0,0,0,2,1,1,100.0,0,1,0,1,0,2,1,0,Matches
30c220c3,Mitchell Weiser,de GER,"DF,FW",Werder Bremen,28-347,1994,21.4,57,36,27,23,7,28,55,50.9,27,38,5,33,24,81,26,1,Matches
dd676a97,Noah Weißhaupt,de GER,"MF,FW",Freiburg,21-195,2001,1.8,6,1,2,3,1,2,5,40.0,3,2,0,2,2,8,5,0,Matches
1c86aa16,Marcel Wenig,de GER,MF,Eint Frankfurt,18-334,2004,0.0,0,0,0,0,0,0,0,,0,0,0,0,0,0,0,0,Matches
49fe9070,Timo Werner,de GER,"FW,MF",RB Leipzig,27-028,1996,15.5,6,3,3,2,1,3,10,30.0,7,9,0,9,5,11,5,0,Matches
f68b64fc,Silvan Widmer,ch SUI,DF,Mainz 05,30-029,1993,15.1,22,14,14,7,1,16,28,57.1,12,18,6,12,30,52,20,0,Matches
cb11b429,Patrick Wimmer,at AUT,"FW,MF",Wolfsburg,21-308,2001,13.5,31,19,14,8,9,11,30,36.7,19,21,2,19,13,44,12,0,Matches
2077ae86,Jonas Wind,dk DEN,FW,Wolfsburg,24-055,1999,8.1,6,1,1,2,3,2,5,40.0,3,7,3,4,1,7,8,0,Matches
a1257b5e,Frederik Winther,dk DEN,DF,Augsburg,22-089,2001,1.0,2,2,1,1,0,0,2,0.0,2,1,1,0,0,2,7,0,Matches
e7fcf289,Florian Wirtz,de GER,"FW,MF",Leverkusen,19-335,2003,6.8,13,7,6,7,0,6,11,54.5,5,8,1,7,1,14,6,0,Matches
be42a291,Hannes Wolf,at AUT,FW,M'Gladbach,23-352,1999,3.8,9,6,4,4,1,3,9,33.3,6,3,0,3,2,11,7,0,Matches
fa661778,Marius Wolf,de GER,DF,Dortmund,27-311,1995,13.7,20,14,8,9,3,13,25,52.0,12,34,9,25,17,37,22,1,Matches
6190474d,Jeong Woo-yeong,kr KOR,"MF,FW",Freiburg,23-195,1999,6.8,7,3,4,2,1,2,5,40.0,3,7,1,6,1,8,7,0,Matches
ea0893d6,Kelvin Yeboah,it ITA,"FW,MF",Augsburg,22-332,2000,2.8,3,3,1,2,0,1,4,25.0,3,4,0,4,1,4,2,0,Matches
caffaf5a,Maya Yoshida,jp JPN,DF,Schalke 04,34-222,1988,25.9,31,20,18,13,0,16,24,66.7,8,34,27,7,45,76,123,1,Matches
a4effc55,Dan-Axel Zagadou,fr FRA,DF,Stuttgart,23-304,1999,8.3,9,6,7,2,0,4,10,40.0,6,12,10,2,9,18,44,1,Matches
fc3697dd,Rodrigo Zalazar,uy URU,"MF,FW",Schalke 04,23-234,1999,10.4,12,7,5,6,1,7,18,38.9,11,12,1,11,5,17,10,0,Matches
65bf7e2b,Aaron Zehnter,de GER,DF,Augsburg,18-154,2004,0.0,0,0,0,0,0,0,1,0.0,1,0,0,0,1,1,0,0,Matches
5c4bf6ba,Robin Zentner,de GER,GK,Mainz 05,28-157,1994,20.0,0,0,0,0,0,0,4,0.0,4,0,0,0,0,0,13,1,Matches
9b688ae1,Michael Zetterer,de GER,GK,Werder Bremen,27-265,1995,1.7,0,0,0,0,0,0,0,,0,0,0,0,0,0,1,0,Matches
29f7cfd9,Simon Zoller,de GER,FW,Bochum,31-281,1991,14.2,8,2,2,6,0,3,9,33.3,6,13,1,12,6,14,20,0,Matches
