id,Tkl,TklW,Def 3rd,Mid 3rd,Att 3rd,Tkl.1,Att,Lost,Blocks,Sh,Pass,Int,Tkl+Int,Clr,Err
000b3da6,70,45,36,27,7,22,55,33,19,2,17,29,99,23,0
003a5c72,52,37,19,23,10,19,73,54,43,13,30,41,93,30,0
00b28772,21,13,10,8,3,8,16,8,15,6,9,16,37,8,0
011d8c56,0,0,0,0,0,0,1,1,0,0,0,2,2,7,0
01ae64cd,2,2,2,0,0,0,1,1,2,1,1,2,4,19,0
01eb744d,41,29,12,16,13,8,57,49,30,1,29,25,66,17,0
02c15616,15,8,7,8,0,6,11,5,7,0,7,5,20,8,0
02d2c436,49,43,37,9,3,17,33,16,32,21,11,77,126,185,1
04965583,6,4,2,3,1,1,10,9,4,0,4,9,15,1,0
04a65a8f,35,22,17,17,1,7,25,18,10,3,7,23,58,20,0
04ac8285,0,0,0,0,0,0,0,0,0,0,0,0,0,0,0
04e17fd5,31,25,10,14,7,6,26,20,11,0,11,9,40,32,0
05384ea1,33,24,21,8,4,14,25,11,21,11,10,39,72,64,1
05a4465d,95,65,38,51,6,24,89,65,34,11,23,35,130,67,0
0657888a,22,14,6,8,8,9,22,13,16,1,15,14,36,15,0
070a3904,64,43,29,28,7,19,62,43,31,5,26,52,116,48,1
07a0baa9,3,2,1,0,2,2,3,1,0,0,0,0,3,2,0
07d67579,1,1,0,1,0,0,6,6,6,0,6,1,2,5,0
080ac8d8,3,2,0,0,3,1,1,0,0,0,0,0,3,0,0
08511d65,40,29,22,18,0,19,28,9,22,12,10,47,87,91,0
0959c2a2,25,16,12,10,3,8,15,7,12,1,11,21,46,17,0
09a9e921,10,2,2,4,4,1,12,11,16,1,15,8,18,16,0
0a0cc13c,13,7,3,6,4,3,11,8,12,1,11,6,19,5,0
0a447501,8,8,0,4,4,0,3,3,5,0,5,4,12,6,0
0ac94a23,27,16,12,10,5,6,23,17,18,1,17,13,40,10,0
0ae4e09a,8,4,2,5,1,2,13,11,11,0,11,1,9,5,0
0af4dcf0,10,7,3,6,1,1,7,6,9,1,8,3,13,27,0
0b90bb97,17,9,4,9,4,4,22,18,14,1,13,2,19,19,0
0c3f7197,14,7,6,7,1,6,11,5,7,1,6,4,18,7,0
0d10333c,90,69,28,54,8,29,74,45,38,4,34,38,128,27,0
0e7ccfc4,18,13,7,8,3,9,16,7,18,4,14,16,34,20,0
0ef89a37,27,14,8,14,5,9,32,23,14,0,14,6,33,4,0
0f138d5a,13,9,8,5,0,3,13,10,9,5,4,14,27,30,0
1001ae82,32,18,6,21,5,6,26,20,18,1,17,7,39,8,0
102fda08,0,0,0,0,0,0,0,0,0,0,0,0,0,0,0
10e25802,6,4,4,2,0,2,4,2,7,1,6,9,15,8,1
113fb4ea,0,0,0,0,0,0,0,0,0,0,0,0,0,2,0
119b9a8e,38,23,27,11,0,14,25,11,19,13,6,27,65,94,1
11c30a46,6,4,1,4,1,1,5,4,5,0,5,4,10,0,0
1214f0a6,4,3,4,0,0,2,4,2,2,1,1,0,4,1,0
1250086e,16,10,10,4,2,8,12,4,15,8,7,19,35,33,1
12a875ce,0,0,0,0,0,0,1,1,0,0,0,0,0,0,0
12c50af5,11,9,3,8,0,3,8,5,7,0,7,2,13,3,0
130a7a3f,41,28,22,10,9,13,62,49,39,5,34,22,63,37,0
13b0c150,16,11,8,7,1,10,15,5,17,12,5,12,28,72,0
148d4105,11,5,3,7,1,4,9,5,2,0,2,8,19,8,0
1512328c,38,23,17,13,8,15,47,32,25,3,22,13,51,9,0
1633fc8a,48,30,28,20,0,30,43,13,27,19,8,53,101,137,0
167c1bb0,34,22,18,16,0,13,40,27,19,12,7,25,59,78,1
174651c8,17,10,7,7,3,7,18,11,10,5,5,20,37,30,1
174f09a6,19,10,11,7,1,4,15,11,23,13,10,33,52,113,0
1771f2c1,36,27,20,14,2,13,24,11,21,7,14,30,66,50,2
1961b2aa,19,12,8,10,1,5,13,8,7,1,6,4,23,6,0
19b776e9,33,24,12,16,5,6,27,21,19,2,17,18,51,10,0
1a317a1b,34,25,24,9,1,18,30,12,18,3,15,19,53,50,1
1b17ed86,32,22,15,13,4,9,27,18,19,0,19,19,51,21,0
1b84dbe1,22,17,13,6,3,8,12,4,15,3,12,12,34,18,0
1bda5842,30,24,9,11,10,8,33,25,14,0,14,12,42,1,0
1c8dc17d,25,16,10,10,5,10,28,18,7,0,7,17,42,14,0
1d1691ad,41,27,22,15,4,20,35,15,25,7,18,26,67,50,0
1d5f96d9,7,3,2,3,2,3,8,5,6,2,4,1,8,10,0
1f079188,41,28,20,17,4,20,42,22,24,6,18,30,71,31,0
1fa85681,0,0,0,0,0,0,0,0,0,0,0,0,0,0,0
1fb1c435,23,13,9,12,2,3,21,18,14,2,12,17,40,11,1
1fe0492d,76,40,42,27,7,35,59,24,40,10,30,44,120,94,0
1fe67e86,34,24,17,13,4,15,27,12,24,5,19,17,51,61,0
20b9f052,0,0,0,0,0,0,0,0,0,0,0,1,1,15,2
21164a21,4,2,2,2,0,2,3,1,3,2,1,1,5,4,0
217011a0,7,6,2,4,1,1,1,0,4,0,4,0,7,0,0
21d4e122,46,29,29,16,1,25,48,23,28,7,21,42,88,64,1
220c11f1,22,14,2,17,3,3,29,26,10,0,10,5,27,32,0
22df75d8,1,0,1,0,0,0,0,0,1,0,1,0,1,0,0
2306bfde,1,0,0,1,0,1,2,1,5,0,5,5,6,1,0
23593121,15,11,3,12,0,3,11,8,7,0,7,2,17,4,0
23f32ea1,0,0,0,0,0,0,1,1,0,0,0,1,1,0,0
240d3a0b,80,59,23,47,10,31,80,49,28,4,24,70,150,25,0
24279b8b,1,0,1,0,0,1,3,2,0,0,0,1,2,5,4
244f57b9,3,2,2,0,1,0,4,4,1,0,1,2,5,1,0
24f59bb2,26,17,15,8,3,10,18,8,21,2,19,20,46,37,1
251336da,24,17,11,10,3,9,16,7,13,4,9,22,46,11,1
2513a588,13,10,3,5,5,1,7,6,6,0,6,5,18,8,0
2515040a,25,16,21,3,1,10,17,7,10,6,4,20,45,84,0
25c72b36,0,0,0,0,0,0,0,0,0,0,0,0,0,1,0
26f2473f,1,1,1,0,0,1,2,1,0,0,0,1,2,9,2
283c7121,1,0,0,0,1,0,1,1,1,0,1,2,3,2,0
28d596a0,0,0,0,0,0,0,2,2,0,0,0,2,2,6,2
293211e1,11,8,2,6,3,1,6,5,6,0,6,3,14,18,0
294450ba,20,15,12,7,1,11,21,10,13,5,8,10,30,27,1
2946f9a1,55,40,29,19,7,20,38,18,21,9,12,46,101,51,0
29b61deb,80,54,28,48,4,23,87,64,28,3,25,30,110,25,0
2a0c8ba4,31,24,8,19,4,10,68,58,24,0,24,30,61,12,0
2a70c756,17,10,3,12,2,4,12,8,11,1,10,3,20,4,0
2b15a82a,4,2,3,1,0,1,1,0,0,0,0,5,9,8,0
2bee98fd,15,12,1,10,4,3,22,19,6,3,3,10,25,12,0
2cea96ce,13,10,10,3,0,7,16,9,6,0,6,14,27,27,0
2e23c66b,4,3,0,0,4,0,6,6,8,1,7,5,9,17,0
2e8fc160,54,38,27,23,4,18,42,24,22,10,12,22,76,37,0
2ef16f06,0,0,0,0,0,0,2,2,1,0,1,0,0,0,0
2f3e911a,56,36,41,12,3,31,59,28,26,5,21,49,105,78,0
3024e383,61,44,36,19,6,38,58,20,31,1,30,38,99,76,0
30672832,0,0,0,0,0,0,1,1,1,0,1,2,2,0,0
307fcd26,1,0,1,0,0,0,0,0,0,0,0,0,1,4,0
31223bcf,21,15,6,10,5,9,23,14,7,0,7,16,37,11,0
314eeab1,0,0,0,0,0,0,0,0,0,0,0,1,1,0,0
322ba2df,12,9,7,5,0,5,9,4,7,1,6,5,17,17,1
32b84cec,1,1,0,1,0,0,1,1,2,0,2,2,3,0,0
335fa267,63,40,30,25,8,25,49,24,18,8,10,39,102,30,1
348e4809,13,6,9,4,0,7,20,13,26,19,7,26,39,92,1
3536fdc1,0,2,0,0,0,0,0,0,0,0,0,1,0,0,0
355c883a,50,33,31,17,2,32,50,18,13,7,6,41,91,66,0
35f6db55,54,34,12,28,14,13,52,39,22,1,21,23,77,25,0
379652be,2,2,2,0,0,0,5,5,2,0,2,3,5,3,0
37e103f8,0,0,0,0,0,0,1,1,0,0,0,0,0,0,0
37f1cf47,57,38,34,14,9,25,38,13,21,2,19,52,109,50,1
37f96552,11,6,4,6,1,3,18,15,14,1,13,18,29,3,0
38699c72,9,5,2,7,0,1,5,4,3,0,3,3,12,2,0
39583cfd,8,5,6,1,1,3,4,1,2,0,2,8,16,0,0
39e9c09a,1,1,1,0,0,1,3,2,1,0,1,0,1,3,0
3a6a49f7,6,6,3,3,0,1,4,3,2,0,2,3,9,4,0
3a9c4b7b,17,14,15,1,1,14,22,8,5,2,3,10,27,18,0
3aa4a3be,14,8,4,5,5,4,17,13,14,1,13,1,15,12,0
3b9f859b,8,6,3,3,2,3,7,4,4,0,4,13,21,11,0
3c7bc9bd,99,61,47,48,4,48,101,53,30,5,25,77,176,40,0
3d7e48ce,20,16,4,9,7,1,10,9,9,0,9,5,25,1,0
3e1858af,14,11,2,11,1,2,12,10,11,0,11,22,36,4,0
3e4f735d,58,44,42,14,2,38,74,36,31,3,28,58,116,89,1
3e5a168c,1,0,1,0,0,1,3,2,0,0,0,2,3,1,0
3ecc11d8,12,7,8,4,0,6,9,3,8,2,6,11,23,18,0
3eed9821,50,35,35,15,0,20,29,9,25,17,8,37,87,72,3
3f10bd22,32,25,17,9,6,12,26,14,14,5,9,19,51,37,0
3f79a1c8,59,35,21,32,6,17,39,22,26,3,23,32,91,19,0
3fc45c73,42,29,29,12,1,23,40,17,26,12,14,53,95,137,0
41c12f75,3,1,1,0,2,3,5,2,3,0,3,1,4,2,0
42276181,11,9,3,4,4,1,10,9,6,0,6,4,15,11,0
4242011c,36,22,29,6,1,18,33,15,27,19,8,66,102,169,0
42dcf26d,38,26,30,7,1,22,41,19,34,23,11,53,91,188,0
43f71e77,18,10,3,6,9,4,27,23,25,4,21,7,25,27,0
4410f0b0,3,2,1,2,0,1,4,3,0,0,0,0,3,0,0
44b61913,16,13,13,3,0,6,14,8,9,7,2,13,29,35,0
45af8a54,26,17,7,13,6,11,26,15,15,0,15,9,35,2,0
45b9b619,15,10,7,6,2,8,29,21,15,1,14,2,17,12,0
45e304c8,10,5,2,4,4,2,6,4,5,0,5,7,17,1,0
4601e194,63,42,35,22,6,26,52,26,34,5,29,68,131,67,1
46166b49,8,5,1,3,4,2,6,4,7,0,7,4,12,9,0
467bae22,39,32,16,15,8,6,34,28,20,2,18,11,50,11,0
46a8347f,48,30,25,17,6,26,40,14,24,8,16,36,84,63,0
46e07328,1,1,0,1,0,0,0,0,0,0,0,0,1,0,0
4737cebe,16,11,2,8,6,5,18,13,12,0,12,11,27,5,0
474ecac8,36,23,30,5,1,18,32,14,27,13,14,40,76,140,1
48593154,6,5,1,3,2,1,3,2,5,0,5,3,9,5,0
485e4939,8,6,4,4,0,3,6,3,3,0,3,8,16,4,0
487d9b09,59,42,40,11,8,24,36,12,22,5,17,24,83,66,0
48e4c485,4,4,1,1,2,2,5,3,2,0,2,2,6,1,0
48e89655,45,32,14,21,10,17,57,40,28,3,25,22,67,16,0
4958bfb2,59,40,27,22,10,22,38,16,33,15,18,38,97,42,2
49ea92be,44,30,18,21,5,16,58,42,31,0,31,21,65,9,0
4a478107,37,23,15,15,7,13,65,52,28,0,28,26,63,20,0
4a895384,2,2,2,0,0,1,4,3,3,2,1,7,9,25,1
4ac7608e,27,19,20,7,0,18,26,8,25,10,15,19,46,69,0
4accb7e0,32,17,11,17,4,13,33,20,14,3,11,14,46,12,0
4b32b2be,1,1,0,1,0,0,0,0,0,0,0,0,1,0,0
4b3f2936,10,6,2,6,2,2,3,1,8,1,7,0,10,1,0
4bc5f2b4,5,2,4,1,0,0,3,3,3,0,3,3,8,2,0
4c0a6a48,1,0,1,0,0,0,1,1,1,0,1,0,1,0,0
4c2e9442,7,4,1,4,2,0,18,18,9,4,5,3,10,34,0
4c5b14d2,22,19,11,10,1,4,16,12,17,2,15,15,37,38,0
4cafb146,2,2,2,0,0,0,0,0,0,0,0,0,2,1,0
4d224fe8,109,78,64,39,6,42,84,42,56,11,45,63,172,49,3
4db76f57,33,18,17,15,1,11,23,12,12,5,7,33,66,40,0
4e2c27bb,1,1,0,0,1,0,0,0,0,0,0,0,1,0,0
4efd29bb,2,0,1,0,1,0,4,4,2,1,1,2,4,9,0
4f28a6ff,67,50,32,35,0,21,38,17,44,27,17,35,102,157,1
4f6d9bcd,2,1,2,0,0,2,7,5,6,1,5,3,5,4,0
4ffb647d,12,5,10,2,0,7,10,3,10,6,4,22,34,67,0
5070881b,15,13,9,6,0,8,9,1,14,8,6,8,23,20,0
50b51fac,25,12,6,16,3,9,24,15,13,5,8,18,43,24,2
51e3954c,35,25,30,5,0,22,36,14,18,6,12,31,66,50,1
529f49ab,94,64,48,39,7,33,69,36,32,7,25,53,147,34,1
532e1e4f,0,0,0,0,0,0,1,1,1,1,0,0,0,4,0
54073b28,54,42,26,23,5,17,62,45,15,3,12,30,84,17,0
5418d47c,2,1,2,0,0,1,4,3,1,0,1,1,3,1,0
54f5ce34,43,24,32,9,2,23,33,10,10,2,8,24,67,46,0
55126f3b,75,45,31,32,12,27,95,68,40,3,37,24,99,38,0
555f3a0b,14,12,13,1,0,8,21,13,15,8,7,25,39,122,0
56cafd0a,0,0,0,0,0,0,0,0,0,0,0,0,0,1,0
576575e5,1,1,1,0,0,0,0,0,2,2,0,8,9,2,0
57ebd662,40,25,14,22,4,12,50,38,25,8,17,38,78,34,0
581c5276,0,0,0,0,0,0,0,0,0,0,0,0,0,0,0
5890cef1,17,15,11,4,2,6,17,11,19,3,16,25,42,52,1
58afe001,56,41,19,30,7,14,47,33,26,3,23,25,81,36,0
58bc7d18,1,0,1,0,0,1,1,0,0,0,0,2,3,6,2
59b7d823,71,42,37,26,8,34,53,19,29,3,26,16,87,46,1
59d53e8a,31,19,22,7,2,16,34,18,16,4,12,21,52,26,0
5a3f6fae,32,22,24,7,1,16,25,9,13,3,10,29,61,49,0
5ab0ea87,88,48,27,46,15,39,79,40,37,10,27,51,139,15,1
5b2a4b8d,4,4,1,2,1,0,1,1,2,0,2,2,6,1,0
5b5724d2,12,6,7,5,0,5,7,2,6,3,3,6,18,29,0
5c256395,3,1,2,1,0,2,3,1,0,0,0,2,5,2,0
5c2da10f,8,5,2,6,0,1,6,5,4,0,4,2,10,4,0
5c7845f6,39,29,17,16,6,14,42,28,20,5,15,32,71,31,0
5ca20b7a,68,52,31,31,6,39,62,23,28,5,23,61,129,85,0
5ce0b5ba,85,57,35,41,9,37,90,53,44,8,36,75,160,35,0
5cec2487,66,48,36,22,8,30,55,25,35,10,25,53,119,89,0
5d311e8d,7,3,7,0,0,5,7,2,3,3,0,10,17,17,0
5db04597,74,55,39,23,12,25,49,24,28,7,21,50,124,82,0
5f0241b2,1,1,1,0,0,0,2,2,0,0,0,1,2,5,3
5f5501ed,15,8,5,6,4,8,21,13,6,0,6,1,16,6,0
5f7db81a,17,13,5,9,3,5,15,10,7,0,7,7,24,5,0
6025fab1,33,22,14,15,4,15,41,26,13,4,9,31,64,7,0
603116a7,53,37,19,23,11,22,58,36,26,2,24,30,83,23,2
60713cb3,0,0,0,0,0,0,0,0,0,0,0,0,0,0,2
608f2092,42,27,31,8,3,21,37,16,24,3,21,32,74,42,2
60ee859c,1,0,0,1,0,1,1,0,1,0,1,0,1,0,0
61220da2,57,36,25,27,5,19,58,39,31,10,21,45,102,37,0
61bb7498,0,0,0,0,0,0,0,0,0,0,0,0,0,2,0
61bd33d0,39,21,12,19,8,13,42,29,36,0,36,18,57,10,0
625c144a,2,1,2,0,0,2,6,4,0,0,0,0,2,10,2
63f04c6c,57,40,24,21,12,19,56,37,39,5,34,32,89,26,0
6434f10d,104,71,50,48,6,30,86,56,49,21,28,52,156,100,1
6435143e,1,1,0,1,0,0,0,0,0,0,0,0,1,0,0
643b39a6,24,19,4,14,6,7,28,21,7,1,6,7,31,5,1
64e8ed6d,6,3,0,4,2,1,5,4,3,0,3,0,6,0,0
65d62814,1,0,1,0,0,1,1,0,1,0,1,0,1,11,2
65d750b5,80,49,39,37,4,38,104,66,28,10,18,44,124,38,0
6639e500,26,15,12,11,3,10,30,20,9,1,8,11,37,5,0
6922f806,24,16,5,10,9,4,23,19,15,2,13,7,31,35,0
6941883f,2,2,1,0,1,0,3,3,1,1,0,4,6,0,0
697295b1,14,9,10,4,0,7,13,6,18,11,7,16,30,41,2
69cbc8b6,19,10,12,7,0,7,17,10,9,5,4,22,41,37,0
6a7586f4,10,4,4,6,0,2,3,1,0,0,0,0,10,0,0
6a99e0b1,28,17,11,15,2,8,41,33,24,2,22,17,45,13,0
6c2f5996,48,33,17,27,4,14,46,32,29,11,18,40,88,72,0
6ca663b4,0,0,0,0,0,0,0,0,1,0,1,1,1,1,0
6ce1f46f,55,35,19,29,7,22,59,37,20,2,18,16,71,10,1
6cffc9df,1,1,1,0,0,1,3,2,0,0,0,0,1,2,0
6d5701f2,10,8,6,4,0,4,6,2,6,3,3,6,16,16,0
6d8f8441,35,23,26,7,2,18,39,21,17,5,12,34,69,46,0
6dce77a5,42,31,18,22,2,10,32,22,22,7,15,35,77,57,0
6df0dc74,4,4,1,3,0,0,5,5,2,2,0,4,8,9,0
6f0d613a,1,1,0,1,0,0,2,2,2,0,2,0,1,1,0
6f51e382,1,0,1,0,0,1,3,2,1,0,1,4,5,12,1
6f5f82c0,3,2,1,2,0,2,5,3,1,0,1,4,7,1,0
6f7d826d,10,9,4,6,0,3,11,8,1,0,1,4,14,0,0
6fb59070,0,0,0,0,0,0,0,0,1,0,1,0,0,10,1
6fd1ba62,42,29,16,15,11,16,65,49,17,0,17,18,60,13,0
70438d35,10,5,5,5,0,6,13,7,5,0,5,11,21,24,1
70d74ece,14,8,2,6,6,3,20,17,18,0,18,8,22,19,0
71d4e271,18,14,8,8,2,5,14,9,13,1,12,16,34,5,0
72a99e38,32,24,12,14,6,7,37,30,19,0,19,16,48,4,1
72b92c4e,5,2,4,1,0,3,6,3,1,0,1,5,10,6,0
730bd100,15,13,6,8,1,7,12,5,5,0,5,5,20,0,0
7329018e,31,23,7,19,5,11,29,18,8,2,6,19,50,16,0
73683fa9,0,0,0,0,0,0,1,1,0,0,0,0,0,1,0
7460ca0d,88,57,35,43,10,31,87,56,37,10,27,34,122,27,1
75751c99,4,3,4,0,0,3,4,1,0,0,0,3,7,22,6
76ee80ee,1,1,0,1,0,1,1,0,0,0,0,0,1,1,0
7789bf63,3,1,1,1,1,1,1,0,0,0,0,3,6,3,0
78c40e94,3,2,1,2,0,1,3,2,3,2,1,2,5,3,0
79135368,62,45,22,34,6,17,66,49,26,4,22,30,92,42,0
7956236f,0,0,0,0,0,0,0,0,0,0,0,0,0,3,0
79c0821a,37,27,19,18,0,8,27,19,9,4,5,5,42,5,0
7a4cd784,1,1,1,0,0,1,1,0,0,0,0,0,1,7,1
7a9fae62,0,0,0,0,0,0,0,0,0,0,0,0,0,3,0
7c218bf9,0,0,0,0,0,0,0,0,0,0,0,0,0,0,0
7c2a398c,19,10,5,10,4,5,17,12,13,0,13,5,24,2,0
7c4243d4,13,10,2,7,4,6,8,2,3,2,1,0,13,5,0
7c689c48,0,0,0,0,0,0,0,0,4,2,2,1,1,0,0
7cefa219,8,5,5,3,0,6,18,12,12,5,7,12,20,16,0
7dcf86f6,26,22,10,10,6,5,34,29,15,1,14,23,49,11,1
7e28d6f7,0,0,0,0,0,0,0,0,0,0,0,0,0,0,0
7eb97a8e,8,4,2,4,2,2,17,15,1,0,1,1,9,2,0
7ebfac0f,9,6,3,5,1,3,9,6,2,0,2,1,10,3,0
7f203b54,20,13,14,6,0,9,18,9,43,27,16,30,50,110,1
808d48f3,67,43,39,22,6,33,51,18,30,8,22,46,113,97,0
81069528,104,69,52,40,12,50,84,34,37,13,24,58,162,104,1
81f0781e,41,28,7,22,12,12,53,41,27,6,21,19,60,46,0
82927de4,52,33,19,26,7,18,60,42,29,3,26,22,74,18,0
833fb62e,8,8,1,5,2,1,7,6,2,0,2,4,12,2,0
83627094,3,2,3,0,0,0,4,4,0,0,0,1,4,6,0
83a83b0a,4,3,4,0,0,3,4,1,1,0,1,3,7,3,0
84399660,22,13,7,12,3,4,22,18,11,0,11,10,32,6,0
8497faf7,36,22,25,10,1,16,28,12,19,5,14,21,57,54,0
8499c713,1,1,0,0,1,0,1,1,1,0,1,0,1,0,0
850c0a0d,38,30,24,12,2,21,40,19,21,10,11,78,116,108,2
8617e3d9,26,20,12,12,2,12,32,20,13,1,12,24,50,25,0
8696bc90,25,20,8,9,8,5,14,9,13,2,11,9,34,5,0
8754c7ca,79,56,35,37,7,28,77,49,36,9,27,46,125,62,0
87882adc,19,11,14,5,0,7,31,24,15,7,8,19,38,32,2
87ec1a2a,16,7,8,6,2,6,29,23,15,0,15,8,24,4,0
8875b8c9,0,0,0,0,0,0,1,1,1,0,1,0,0,11,1
88a359d4,24,14,11,8,5,7,25,18,22,4,18,10,34,49,0
89151b16,22,14,14,6,2,7,12,5,17,13,4,36,58,95,2
895ff3ca,6,2,3,3,0,3,6,3,2,0,2,0,6,0,0
89f951b5,52,31,16,30,6,15,45,30,42,7,35,44,96,16,0
8b6d1830,1,1,0,1,0,0,1,1,4,2,2,2,3,2,0
8b8a56ce,35,24,25,8,2,13,22,9,16,10,6,32,67,109,0
8c3c640c,33,23,10,13,10,7,39,32,32,2,30,18,51,19,0
8c44e37b,9,7,1,6,2,1,13,12,7,0,7,3,12,5,0
8c83efb6,18,9,8,7,3,10,17,7,2,0,2,8,26,5,0
8ca253a3,5,3,2,2,1,1,12,11,7,0,7,2,7,16,0
8cc3d96e,37,24,15,14,8,11,32,21,21,2,19,23,60,13,0
8cfc2f69,28,19,3,19,6,3,26,23,18,3,15,6,34,14,0
8d957256,2,0,2,0,0,2,6,4,0,0,0,4,6,29,3
8db394aa,63,43,44,19,0,28,50,22,27,16,11,66,129,131,4
8e010ff4,38,23,15,18,5,11,45,34,25,1,24,22,60,21,0
8e088e04,30,16,22,6,2,16,27,11,9,3,6,9,39,23,0
8ef81d2d,13,10,4,8,1,5,7,2,2,2,0,3,16,2,0
8f8c6934,1,0,1,0,0,1,1,0,0,0,0,2,3,13,2
9038c2a1,32,25,11,14,7,11,38,27,14,1,13,20,52,8,0
90f83973,2,1,0,1,1,1,5,4,1,1,0,2,4,2,0
9109185e,2,1,2,0,0,2,2,0,0,0,0,0,2,7,1
9243fea6,8,6,3,2,3,3,4,1,4,0,4,2,10,3,0
92b4a127,29,21,14,15,0,14,38,24,22,11,11,43,72,106,2
92d38e6c,48,33,43,5,0,29,46,17,27,12,15,62,110,89,0
93568a16,5,5,2,2,1,1,11,10,2,0,2,5,10,5,0
942b4f90,12,8,2,5,5,1,2,1,10,0,10,5,17,2,0
9592289a,21,14,4,10,7,1,20,19,26,1,25,8,29,34,0
960fb42d,61,40,31,30,0,29,53,24,25,12,13,56,117,91,2
963829d0,61,41,23,34,4,21,71,50,38,13,25,22,83,44,0
967f34d3,0,0,0,0,0,0,2,2,1,0,1,3,3,16,1
9704b62b,1,0,0,1,0,0,4,4,1,1,0,1,2,3,0
9744ff80,27,19,10,13,4,11,49,38,39,1,38,30,57,34,1
97852360,0,0,0,0,0,0,0,0,1,0,1,3,3,12,4
983ccabe,0,0,0,0,0,0,0,0,0,0,0,0,0,0,1
9857e65d,14,8,8,3,3,4,13,9,5,0,5,5,19,1,0
9970da54,0,0,0,0,0,0,0,0,0,0,0,0,0,0,0
999908af,43,30,25,15,3,13,39,26,22,1,21,35,78,21,0
99bebd12,7,7,3,1,3,2,10,8,10,1,9,2,9,7,0
9b337c7c,18,12,7,9,2,3,18,15,18,2,16,16,34,19,0
9b5ce51a,51,35,26,23,2,17,45,28,25,10,15,49,100,43,0
9b878773,3,2,2,1,0,2,11,9,2,0,2,1,4,2,0
9ba48d64,64,44,38,22,4,35,65,30,29,11,18,63,127,121,0
9d2a3d5f,19,15,11,4,4,6,30,24,16,1,15,15,34,20,1
9d4c3227,5,4,4,0,1,1,2,1,1,0,1,3,8,3,0
9d4c45d6,30,20,10,16,4,3,16,13,14,0,14,4,34,9,0
9e098912,0,0,0,0,0,0,0,0,0,0,0,0,0,0,0
9e1035f8,8,7,3,5,0,2,6,4,1,0,1,3,11,1,0
9f0ea33f,2,2,2,0,0,1,5,4,0,0,0,0,2,11,2
9f323c71,28,21,11,15,2,13,29,16,15,2,13,19,47,36,0
9f8e9423,28,19,20,7,1,8,15,7,27,10,17,33,61,109,2
9fa0a0b8,2,1,1,1,0,1,2,1,5,0,5,3,5,0,0
a0b4bb3e,22,12,5,10,7,5,35,30,11,0,11,15,37,2,0
a10361d2,24,14,13,9,2,12,22,10,9,1,8,17,41,12,0
a190d597,17,11,2,10,5,4,15,11,14,4,10,5,22,3,0
a25250f8,78,53,31,39,8,38,114,76,46,3,43,47,125,29,0
a2609621,14,8,12,1,1,5,10,5,13,10,3,16,30,57,1
a300ac7e,17,12,5,8,4,1,32,31,19,1,18,9,26,1,0
a3a306f6,38,20,20,18,0,14,38,24,14,1,13,15,53,12,0
a4971d84,87,65,71,15,1,34,52,18,33,14,19,78,165,190,1
a55d8df5,0,0,0,0,0,0,0,0,0,0,0,0,0,0,0
a58bb1e1,19,13,7,8,4,3,14,11,13,1,12,12,31,18,0
a60823a4,33,23,21,10,2,17,30,13,22,7,15,26,59,45,0
a6154613,17,10,4,5,8,4,19,15,4,3,1,8,25,31,0
a68856b5,2,1,0,2,0,0,1,1,0,0,0,1,3,1,0
a6951bf8,18,14,11,6,1,9,16,7,9,2,7,20,38,23,0
a6b9bd00,11,7,5,6,0,4,17,13,10,1,9,5,16,4,0
a6de370d,30,24,6,18,6,9,32,23,25,0,25,11,41,3,0
a7a9d95a,4,3,0,2,2,0,6,6,5,0,5,11,15,3,0
a7f00c8c,111,77,64,40,7,65,96,31,24,4,20,55,166,113,0
a83d8b0c,10,7,8,2,0,2,4,2,4,2,2,4,14,4,0
a8599c17,1,0,0,1,0,0,0,0,0,0,0,0,1,7,0
a8e6bebf,37,23,15,15,7,11,30,19,15,0,15,18,55,10,0
a8fbae1d,41,22,28,13,0,16,22,6,23,9,14,62,103,140,0
a92669f6,11,8,7,3,1,3,5,2,8,1,7,13,24,24,0
a9dc785c,1,1,1,0,0,1,2,1,1,0,1,1,2,8,3
aa0ac32d,12,9,8,4,0,4,11,7,8,8,0,9,21,60,2
aa55fe48,1,1,0,1,0,0,0,0,0,0,0,1,2,1,0
aaa4239e,1,1,1,0,0,0,1,1,0,0,0,1,2,0,0
aad4f74f,0,0,0,0,0,0,0,0,0,0,0,1,1,4,0
ab13a5aa,0,0,0,0,0,0,0,0,0,0,0,3,3,12,1
ac290817,8,5,5,0,3,3,15,12,7,1,6,6,14,6,0
ac295d9e,4,4,4,0,0,4,11,7,1,0,1,2,6,26,2
ac3fb1be,18,12,15,3,0,10,14,4,22,11,11,24,42,139,0
ac454a4f,35,26,13,21,1,12,37,25,12,4,8,14,49,27,0
ad178594,22,15,18,4,0,14,26,12,23,13,10,30,52,73,0
ad340e17,33,19,13,17,3,11,31,20,20,4,16,23,56,23,0
ad4d0985,106,72,56,45,5,49,113,64,38,14,24,79,185,73,1
ad6295d4,28,19,14,12,2,17,36,19,18,4,14,15,43,44,1
adfc9123,31,22,22,9,0,16,36,20,40,27,13,30,61,127,0
aec0fb6f,32,15,10,18,4,13,42,29,16,5,11,23,55,17,0
b037bd4f,28,20,12,13,3,13,36,23,6,1,5,28,56,12,0
b05e2dbd,77,60,52,22,3,43,68,25,43,12,31,56,133,90,1
b0616e3d,78,49,40,26,12,32,62,30,35,6,29,66,144,69,1
b0fce72c,17,8,6,11,0,4,25,21,14,3,11,8,25,15,0
b14d0c5d,41,28,30,11,0,18,25,7,26,9,17,31,72,101,1
b19db005,10,7,2,5,3,1,13,12,8,0,8,5,15,2,0
b233e8e4,31,24,25,6,0,14,21,7,18,9,9,29,60,85,1
b2d03887,20,15,8,10,2,3,13,10,8,0,8,15,35,13,0
b2d0ec1b,49,36,21,21,7,14,33,19,17,2,15,10,59,17,0
b32b7d1b,2,2,1,0,1,2,3,1,2,0,2,1,3,0,0
b35db3f6,7,5,0,2,5,1,11,10,11,0,11,9,16,16,0
b3dc6eca,33,22,29,4,0,13,25,12,27,18,9,58,91,134,1
b418dbd4,82,51,28,36,18,26,71,45,55,3,52,30,112,23,0
b43b81f1,16,8,12,3,1,10,15,5,6,4,2,29,45,66,2
b579e83d,24,17,9,12,3,12,26,14,17,3,14,27,51,10,0
b5bdf144,0,0,0,0,0,0,2,2,1,0,1,1,1,12,3
b5dd3469,18,16,6,8,4,3,8,5,8,2,6,10,28,11,0
b742cc0d,38,28,30,8,0,21,39,18,19,10,9,32,70,97,1
b7c99b9b,20,15,13,5,2,11,19,8,23,14,9,29,49,109,0
b7ca5c51,47,27,41,4,2,32,46,14,30,14,16,51,98,142,2
b7f2edff,6,4,3,3,0,2,8,6,2,0,2,3,9,8,0
b8836910,61,39,34,22,5,15,47,32,39,7,32,34,95,36,0
ba3ca78f,0,0,0,0,0,0,0,0,0,0,0,2,2,15,0
ba5004e1,86,64,54,21,11,44,90,46,34,8,26,46,132,76,1
ba71d071,9,5,5,4,0,1,3,2,7,3,4,14,23,41,0
bad38a94,29,26,15,9,5,13,18,5,14,3,11,14,43,27,0
bb4b1242,11,8,3,3,5,2,8,6,13,1,12,6,17,8,0
bb7337cc,39,28,17,15,7,11,38,27,25,3,22,15,54,16,1
bba30585,30,22,16,13,1,18,29,11,41,18,23,43,73,96,0
bbe88396,2,1,1,1,0,0,1,1,1,0,1,3,5,3,0
bc6f5f06,52,37,38,13,1,20,34,14,32,22,10,56,108,118,1
bd207a4d,7,3,3,4,0,2,12,10,5,0,5,6,13,1,0
bd6351cd,1,1,0,1,0,1,1,0,1,0,1,2,3,0,0
bdf7b97d,11,8,3,7,1,2,6,4,4,1,3,2,13,9,0
be170419,73,52,54,19,0,38,56,18,52,27,25,67,140,155,2
be3a0121,25,16,20,5,0,15,24,9,25,11,14,35,60,115,0
bf97c188,55,37,35,18,2,36,67,31,32,20,12,42,97,83,1
bfa29677,0,0,0,0,0,0,0,0,1,0,1,0,0,3,0
bfb15d99,0,0,0,0,0,0,0,0,0,0,0,0,0,1,0
c00097d2,35,22,27,8,0,17,32,15,29,18,11,41,76,75,1
c05dfb74,10,8,2,6,2,1,7,6,4,0,4,4,14,3,0
c0617e2b,8,7,3,2,3,4,16,12,6,0,6,5,13,1,0
c0a0c18f,9,6,2,6,1,3,13,10,5,1,4,1,10,5,0
c0b1a6da,0,0,0,0,0,0,0,0,0,0,0,0,0,1,0
c0c7ff58,83,53,34,40,9,26,73,47,35,3,32,42,125,36,1
c0de5ff5,1,1,0,1,0,1,1,0,1,0,1,2,3,2,0
c14bc029,132,90,53,69,10,40,104,64,61,12,49,55,187,77,0
c2111b45,8,7,6,2,0,2,5,3,6,5,1,16,24,21,1
c2846353,20,13,12,8,0,10,20,10,11,6,5,22,42,17,0
c3ee18ef,93,68,51,35,7,55,74,19,35,10,25,40,133,90,0
c4af5889,1,0,1,0,0,1,3,2,1,1,0,1,2,1,1
c4b8bcf4,11,8,2,5,4,1,8,7,7,0,7,7,18,10,0
c5eaff5c,1,1,1,0,0,1,2,1,1,0,1,1,2,0,0
c5fa58ea,48,31,15,29,4,13,38,25,26,6,20,23,71,38,0
c67cd65c,43,24,30,12,1,16,32,16,25,9,16,23,66,83,0
c6e8cf1f,21,16,9,8,4,5,16,11,14,6,8,17,38,13,0
c7526c18,39,26,14,19,6,20,30,10,27,8,19,28,67,36,2
c818c4d9,0,0,0,0,0,0,1,1,0,0,0,0,0,0,0
c84c1afc,0,0,0,0,0,0,1,1,0,0,0,0,0,2,0
c8aa95da,59,45,45,14,0,32,61,29,36,20,16,45,104,141,1
c904f3d5,6,5,6,0,0,4,6,2,5,1,4,5,11,13,2
c90977db,14,8,5,8,1,4,23,19,10,1,9,7,21,3,0
c9cb972b,0,0,0,0,0,0,0,0,0,0,0,0,0,2,0
c9e39d91,19,15,9,6,4,7,17,10,13,0,13,4,23,12,0
cac2537b,39,26,14,16,9,10,38,28,11,0,11,16,55,7,0
cb574619,84,55,55,26,3,35,53,18,30,15,15,68,152,111,1
cbdf7d5c,1,0,0,1,0,1,1,0,0,0,0,0,1,0,0
cc29324e,2,2,1,1,0,1,5,4,5,3,2,6,8,8,0
cc2dd8a5,2,2,0,2,0,0,0,0,0,0,0,0,2,0,0
cce181df,88,57,38,43,7,23,68,45,46,14,32,62,150,66,0
cefb32b1,21,13,6,11,4,10,29,19,18,4,14,17,38,14,1
cfd65a29,28,22,11,8,9,6,31,25,21,2,19,10,38,12,1
cfd68aa7,0,0,0,0,0,0,0,0,0,0,0,0,0,1,0
cfd8d664,33,24,21,9,3,21,32,11,14,4,10,26,59,35,0
d04b94db,34,25,19,11,4,17,29,12,16,2,14,22,56,26,1
d054d8b0,18,14,5,9,4,2,10,8,8,2,6,7,25,20,0
d0d79694,13,9,7,5,1,5,11,6,10,3,7,18,31,28,0
d109f62b,1,1,0,0,1,0,0,0,0,0,0,0,1,2,0
d1491e00,33,25,7,13,13,9,44,35,18,1,17,12,45,9,0
d189e48f,0,0,0,0,0,0,0,0,1,0,1,0,0,0,0
d24e154c,0,0,0,0,0,0,1,1,0,0,0,0,0,0,1
d2ac648c,21,10,8,10,3,6,21,15,6,1,5,19,40,9,0
d2be40f2,20,14,8,12,0,8,19,11,12,5,7,25,45,51,2
d2fa73e7,48,34,19,23,6,21,62,41,21,1,20,15,63,15,0
d3272fba,3,3,1,2,0,0,4,4,1,0,1,1,4,0,0
d49f3e6b,12,8,3,7,2,3,10,7,5,0,5,6,18,4,0
d4c9725f,21,15,16,2,3,13,25,12,9,2,7,17,38,20,0
d4ef9ac5,12,11,11,1,0,5,10,5,4,0,4,6,18,29,0
d5127c3f,1,1,0,1,0,0,1,1,0,0,0,0,1,0,0
d66b9872,9,4,0,2,7,0,4,4,18,2,16,9,18,5,0
d70a2141,32,23,15,16,1,11,24,13,14,4,10,38,70,77,2
d70ce98e,17,8,0,11,6,2,18,16,11,1,10,7,24,0,0
d79afcfc,11,8,2,7,2,3,8,5,7,0,7,6,17,1,0
d83bbc54,30,21,8,18,4,8,25,17,23,3,20,30,60,47,0
d8712bf9,9,7,1,4,4,3,8,5,5,0,5,3,12,1,0
d87e2cae,10,7,1,5,4,2,9,7,10,1,9,5,15,31,0
d9764034,28,16,24,4,0,17,32,15,19,10,9,36,64,108,0
d9b0cc38,0,0,0,0,0,0,0,0,0,0,0,0,0,0,0
d9ba39fc,68,43,37,21,10,36,53,17,30,6,24,76,144,61,0
d9bda115,49,36,22,25,2,20,49,29,32,10,22,41,90,24,1
d9faee7e,4,1,2,2,0,1,2,1,3,0,3,0,4,0,0
da27e268,8,7,3,5,0,3,4,1,4,2,2,4,12,10,0
dac68523,47,27,20,25,2,20,37,17,23,6,17,38,85,16,1
db0cd1ae,33,24,24,7,2,20,45,25,28,14,14,30,63,114,3
db714daf,6,3,2,3,1,1,5,4,0,0,0,2,8,3,0
db750822,24,18,13,8,3,7,32,25,20,4,16,12,36,14,0
dbe5a587,22,10,17,5,0,15,27,12,16,13,3,25,47,51,1
dc008610,9,7,4,4,1,4,17,13,9,2,7,3,12,12,0
dc4511f3,0,0,0,0,0,0,1,1,0,0,0,0,0,1,3
de39485a,17,13,7,5,5,3,8,5,9,0,9,4,21,3,0
de7d40d6,15,13,9,6,0,7,19,12,7,1,6,11,26,25,0
dea698d9,7,4,3,3,1,1,6,5,10,3,7,6,13,14,0
debc6b55,0,0,0,0,0,0,1,1,2,0,2,0,0,0,0
def69cd0,24,13,7,16,1,12,34,22,15,5,10,23,47,12,1
df69b544,36,24,6,23,7,10,30,20,20,1,19,10,46,14,0
df9326db,2,1,1,1,0,0,0,0,1,0,1,3,5,4,0
e08647d6,2,1,1,1,0,0,2,2,1,0,1,0,2,0,0
e0cd04e0,12,7,5,3,4,6,7,1,2,0,2,0,12,1,0
e12d7851,25,22,12,9,4,17,25,8,11,3,8,16,41,68,0
e185aa52,9,7,2,7,0,1,7,6,10,4,6,11,20,10,0
e1cbb531,64,45,24,35,5,23,65,42,25,9,16,39,103,22,0
e1cea3f7,15,11,7,5,3,4,22,18,6,0,6,4,19,7,0
e1deea75,7,7,6,1,0,4,7,3,6,3,3,10,17,22,0
e208bcc8,34,19,18,15,1,6,22,16,15,4,11,14,48,4,0
e28868f3,102,78,60,31,11,43,91,48,48,8,40,93,195,92,1
e42d61c7,21,15,9,6,6,11,25,14,9,1,8,10,31,19,1
e4b8c5b6,36,28,24,12,0,11,20,9,18,11,7,24,60,84,0
e4ed2628,83,52,41,33,9,36,49,13,27,7,20,35,118,34,0
e54bd0a2,71,49,27,38,6,20,40,20,28,10,18,43,114,37,0
e5cd9da6,39,21,24,14,1,10,18,8,18,7,11,15,54,65,1
e6bc67d7,38,26,18,15,5,16,51,35,22,0,22,16,54,10,0
e7375367,6,5,4,2,0,5,11,6,7,4,3,8,14,15,0
e7ab4179,25,14,21,4,0,14,20,6,10,8,2,17,42,71,2
e7f4603c,39,18,15,18,6,13,39,26,31,2,29,30,69,15,0
e897d8ba,14,8,1,7,6,2,11,9,15,1,14,10,24,14,0
e9a12436,23,17,13,8,2,11,20,9,8,1,7,19,42,26,0
ea6a7ab4,25,21,9,12,4,9,45,36,21,1,20,17,42,10,0
eb2fe5b6,16,9,2,8,6,2,23,21,16,2,14,3,19,4,1
eb5bc3eb,50,27,31,17,2,19,29,10,17,5,12,24,74,55,0
ec3efd7f,12,10,7,4,1,4,14,10,5,0,5,4,16,6,0
ec699fdd,16,14,11,5,0,10,15,5,7,5,2,12,28,53,1
ecada4fc,2,1,2,0,0,1,1,0,0,0,0,3,5,10,2
ecd8c01e,8,5,5,2,1,4,6,2,0,0,0,2,10,0,0
ed239245,39,26,23,13,3,24,41,17,26,9,17,36,75,68,0
ed79b7d3,1,1,0,1,0,0,1,1,5,0,5,0,1,2,0
ee8508c0,0,0,0,0,0,0,0,0,0,0,0,2,2,7,0
ef322658,41,27,17,18,6,15,55,40,27,5,22,22,63,29,1
ef345601,31,24,13,14,4,12,36,24,8,0,8,23,54,5,0
efa708aa,36,25,10,22,4,3,28,25,21,0,21,11,47,2,0
f03f284b,67,49,47,19,1,27,54,27,43,26,17,67,134,161,0
f0a31c00,21,15,8,12,1,14,31,17,10,2,8,15,36,11,0
f0da930c,38,27,29,6,3,23,35,12,28,15,13,30,68,101,1
f11fe861,25,18,18,7,0,13,26,13,11,3,8,31,56,107,0
f1bed920,44,32,18,20,6,19,34,15,22,6,16,27,71,39,0
f3112790,36,21,25,8,3,21,38,17,17,9,8,47,83,64,0
f3b1d9a2,78,53,32,28,18,24,89,65,36,3,33,33,111,20,0
f519b556,2,2,0,2,0,0,5,5,2,0,2,1,3,11,0
f573a8bf,9,7,4,4,1,3,8,5,2,0,2,5,14,0,0
f6798fc3,1,1,1,0,0,0,2,2,0,0,0,4,5,14,0
f69d934e,27,16,16,9,2,11,16,5,5,1,4,14,41,13,0
f69e9eee,1,0,1,0,0,1,3,2,0,0,0,1,2,2,3
f6ac68c1,30,20,23,7,0,16,39,23,38,23,15,45,75,150,1
f7dc2ae5,32,20,20,9,3,19,30,11,20,7,13,45,77,84,0
f8eca1b6,15,11,2,6,7,1,22,21,23,4,19,6,21,16,0
fa6561bf,1,1,1,0,0,1,1,0,0,0,0,0,1,2,0
fa937f7a,71,53,25,37,9,22,63,41,23,1,22,12,83,17,3
faec2ec4,75,47,36,36,3,29,67,38,20,7,13,26,101,48,0
fb5d47b3,110,66,63,37,10,58,87,29,58,11,47,58,168,114,0
fbd6378b,54,35,27,25,2,19,34,15,39,24,15,71,125,133,3
fc4f85b1,50,33,37,11,2,26,47,21,33,20,13,59,109,145,1
fc8cb238,1,0,1,0,0,1,1,0,1,0,1,1,2,6,0
fd47b4f2,32,18,26,6,0,19,34,15,45,36,9,50,82,183,0
fd51b456,48,33,16,21,11,12,42,30,28,2,26,7,55,9,0
fd9c4805,18,12,8,6,4,9,33,24,12,1,11,12,30,7,1
fe05804b,21,14,16,5,0,13,27,14,21,10,11,39,60,124,0
fed17f5a,51,32,21,21,9,22,53,31,25,1,24,5,56,19,0
ffad706e,47,35,31,12,4,18,35,17,7,2,5,18,65,48,0
