id,Tkl,TklW,Def 3rd,Mid 3rd,Att 3rd,Tkl.1,Att,Lost,Blocks,Sh,Pass,Int,Tkl+Int,Clr,Err,recov
004d185e,31,17,17,9,5,9,39,30,20,0,20,13,44,28,0,100
0076ab7f,23,12,16,5,2,4,10,6,10,6,4,24,47,24,2,48
00b28772,50,28,22,24,4,19,46,27,40,9,31,57,107,46,1,133
01e5f06e,29,10,17,9,3,11,22,11,15,0,15,14,43,9,0,47
01eb744d,38,21,10,23,5,15,45,30,18,1,17,22,60,16,0,118
02319ad7,12,7,1,3,8,3,18,15,13,2,11,6,18,16,0,62
02c15616,71,42,21,40,10,26,62,36,40,3,37,29,100,28,0,182
036bba5f,54,29,32,21,1,30,80,50,35,8,27,31,85,28,0,153
037dbd30,18,10,11,6,1,9,19,10,11,2,9,12,30,20,0,64
039ae103,0,0,0,0,0,0,1,1,0,0,0,2,2,2,0,10
03dc5b1f,0,0,0,0,0,0,1,1,1,0,1,0,0,0,0,7
04965583,9,5,5,3,1,5,12,7,10,1,9,12,21,9,0,39
04981123,12,7,4,5,3,6,18,12,10,0,10,4,16,2,0,23
04ac8285,0,0,0,0,0,0,0,0,0,0,0,0,0,0,0,12
04e17fd5,17,11,2,9,6,4,21,17,15,0,15,8,25,23,0,43
056269d7,52,33,28,17,7,30,53,23,19,6,13,20,72,48,2,119
05a4465d,24,13,10,13,1,8,35,27,16,1,15,12,36,21,0,54
062fc2e6,28,17,16,8,4,15,21,6,14,4,10,20,48,32,0,68
08511d65,15,12,8,6,1,6,10,4,9,5,4,19,34,39,1,82
08990838,7,4,2,4,1,2,5,3,2,0,2,11,18,21,0,34
0959c2a2,25,16,9,8,8,10,26,16,16,2,14,22,47,4,0,80
09a9e921,9,5,5,3,1,3,5,2,5,0,5,3,12,2,0,19
0a0cc13c,6,2,0,4,2,2,8,6,4,0,4,3,9,2,0,26
0a447501,5,5,0,4,1,0,2,2,8,1,7,3,8,9,0,34
0a8bcb23,7,3,3,2,2,1,8,7,2,0,2,2,9,3,0,34
0ac94a23,19,15,6,7,6,6,26,20,15,1,14,12,31,15,0,53
0ae4e09a,11,7,5,4,2,6,23,17,10,3,7,4,15,6,0,50
0b2c8585,48,28,21,22,5,16,52,36,25,3,22,49,97,25,0,185
0b90bb97,31,13,9,12,10,6,37,31,15,3,12,6,37,17,0,82
0ba976e4,9,4,2,4,3,2,10,8,4,0,4,3,12,1,0,13
0bbab654,1,0,1,0,0,0,5,5,1,1,0,4,5,5,0,8
0bc4e720,18,8,5,8,5,5,26,21,8,0,8,3,21,3,0,35
0c3f7197,8,4,1,3,4,0,3,3,5,0,5,5,13,0,0,20
0c717ae6,1,1,1,0,0,0,0,0,1,1,0,3,4,9,0,7
0cc474e7,1,1,0,1,0,0,0,0,0,0,0,1,2,1,0,4
0d298637,0,0,0,0,0,0,1,1,0,0,0,0,0,1,0,0
0d9b2d31,44,27,16,16,12,17,71,54,46,1,45,33,77,7,0,142
0dce3356,2,1,2,0,0,2,2,0,1,0,1,0,2,1,0,3
0e4fef6e,32,15,11,19,2,21,34,13,16,7,9,27,59,43,0,99
0e5ddc7c,4,3,2,1,1,0,11,11,3,0,3,2,6,4,0,44
0ef89a37,8,6,2,5,1,3,9,6,7,0,7,2,10,1,0,24
0f7dbaf6,0,0,0,0,0,0,0,0,0,0,0,0,0,0,0,2
10072610,0,0,0,0,0,0,1,1,0,0,0,0,0,11,0,24
11b9265b,7,4,7,0,0,2,5,3,2,1,1,3,10,2,0,6
12c50af5,64,32,22,30,12,21,94,73,30,2,28,22,86,15,2,175
12eda7be,20,9,5,15,0,8,23,15,14,1,13,9,29,12,0,57
132ac341,20,11,13,6,1,7,12,5,22,19,3,34,54,127,1,137
15781606,4,3,3,1,0,0,9,9,5,1,4,5,9,4,0,21
16aa3654,8,5,2,3,3,2,19,17,16,0,16,15,23,6,0,53
16e9d0ea,42,26,25,12,5,20,43,23,18,4,14,35,77,48,0,132
174651c8,13,9,5,6,2,9,21,12,5,1,4,19,32,32,1,80
18017beb,4,2,2,2,0,0,3,3,2,0,2,2,6,3,0,8
1827a42d,12,9,8,4,0,5,11,6,4,3,1,13,25,27,0,29
1840e36d,0,0,0,0,0,0,1,1,1,0,1,1,1,17,2,50
18abe173,26,17,17,9,0,12,21,9,7,4,3,25,51,88,1,89
19709006,15,9,3,8,4,6,13,7,2,0,2,10,25,1,0,40
19b776e9,30,14,9,16,5,8,19,11,19,0,19,15,45,12,0,58
19c36442,22,11,11,10,1,6,28,22,10,0,10,24,46,16,1,79
1a317a1b,10,8,5,5,0,6,20,14,5,1,4,9,19,10,0,24
1b40049a,7,3,3,2,2,4,16,12,4,0,4,6,13,1,0,33
1bacc518,44,27,21,19,4,15,35,20,20,4,16,38,82,29,2,215
1bda5842,18,8,4,10,4,7,36,29,24,2,22,8,26,5,0,85
1c2c55fc,34,19,26,8,0,16,28,12,40,30,10,52,86,113,0,154
1c772b46,0,0,0,0,0,0,0,0,0,0,0,0,0,0,0,2
1d1691ad,14,7,5,8,1,3,5,2,6,3,3,6,20,12,1,36
1daec722,64,51,19,40,5,25,66,41,45,4,41,40,104,27,0,202
1e465e70,3,1,2,1,0,1,3,2,2,0,2,4,7,2,0,11
1f079188,25,14,8,15,2,19,33,14,20,1,19,13,38,19,0,56
1fe0492d,55,30,28,21,6,23,52,29,44,6,38,66,121,72,0,120
1fe67e86,26,15,11,12,3,9,18,9,22,7,15,7,33,46,0,84
200e89e1,29,19,5,18,6,9,24,15,20,0,20,6,35,8,0,78
21512407,61,39,30,25,6,26,52,26,22,4,18,40,101,58,1,146
217011a0,0,0,0,0,0,0,0,0,0,0,0,0,0,0,0,2
228b0d9d,23,16,15,5,3,11,19,8,12,2,10,10,33,31,0,57
237a3851,26,19,8,14,4,7,33,26,10,1,9,17,43,18,0,71
23c5db70,2,0,0,2,0,0,0,0,2,0,2,0,2,0,0,0
23fffc06,2,1,1,0,1,0,1,1,0,0,0,0,2,0,0,1
240d3a0b,39,19,10,23,6,15,46,31,20,7,13,33,72,34,0,146
24279b8b,0,0,0,0,0,0,0,0,0,0,0,0,0,1,0,3
244f57b9,7,3,1,2,4,5,20,15,5,0,5,14,21,3,0,37
24f59bb2,1,1,1,0,0,0,1,1,5,3,2,4,5,7,0,15
253a06b9,6,2,3,1,2,2,4,2,1,0,1,1,7,0,0,9
2784f898,20,8,13,6,1,8,14,6,19,6,13,19,39,42,0,70
27a013f7,24,16,14,9,1,7,15,8,23,18,5,43,67,89,2,134
283c7121,51,30,16,31,4,20,66,46,25,4,21,22,73,17,0,206
2946f9a1,27,14,13,11,3,12,35,23,19,9,10,40,67,58,0,98
29ad0dd4,0,0,0,0,0,0,0,0,0,0,0,0,0,0,0,0
29b61deb,20,10,8,8,4,5,16,11,15,2,13,7,27,10,0,68
2a0c8ba4,52,28,17,29,6,17,76,59,22,3,19,27,79,25,0,170
2a8c9f98,5,1,1,2,2,2,5,3,2,0,2,4,9,6,0,34
2b65fe46,7,3,1,4,2,5,10,5,4,0,4,6,13,5,1,42
2b6dc4d7,1,1,0,0,1,0,1,1,0,0,0,0,1,0,0,0
2bef2bca,22,11,12,8,2,9,9,0,24,15,9,20,42,47,1,104
2ceb58ab,21,13,13,8,0,12,31,19,7,1,6,14,35,12,0,91
2e5e846d,6,4,3,1,2,2,13,11,9,0,9,9,15,13,0,47
2f3e911a,34,20,15,16,3,10,33,23,15,4,11,13,47,37,0,72
3024e383,15,8,9,4,2,8,12,4,7,0,7,13,28,17,1,81
307fcd26,0,0,0,0,0,0,0,0,0,0,0,0,0,3,2,18
31f5b89b,11,8,2,8,1,5,8,3,3,1,2,6,17,7,0,29
32974271,11,5,1,5,5,2,27,25,12,1,11,7,18,16,3,59
32c0491f,1,1,1,0,0,1,2,1,0,0,0,0,1,3,0,5
335039a2,24,17,12,10,2,8,37,29,17,5,12,13,37,17,1,84
335fa267,9,6,5,2,2,7,13,6,12,6,6,10,19,20,0,62
3376a776,7,5,2,5,0,1,4,3,8,3,5,6,13,17,0,25
33a61a52,56,29,33,16,7,22,39,17,26,4,22,37,93,55,1,185
34269bdf,93,44,50,34,9,32,83,51,56,13,43,53,146,75,2,226
34caa4b3,1,1,0,1,0,1,2,1,2,0,2,1,2,0,0,2
34e393f2,98,56,52,40,6,40,85,45,52,14,38,68,166,58,2,229
3521abfe,5,4,4,1,0,3,6,3,5,3,2,6,11,24,0,10
355c883a,32,18,17,12,3,17,33,16,9,3,6,27,59,36,0,81
35a6e5c7,3,0,3,0,0,1,4,3,3,0,3,3,6,0,0,5
3624ce4c,21,10,13,6,2,10,19,9,14,8,6,16,37,39,0,55
3672b352,9,4,1,6,2,5,12,7,9,0,9,5,14,4,0,37
374ee424,0,0,0,0,0,0,1,1,0,0,0,3,3,14,0,63
379dc075,12,9,4,5,3,2,23,21,17,3,14,8,20,7,0,58
37e103f8,0,0,0,0,0,0,0,0,1,0,1,0,0,0,0,0
37f04799,12,8,10,1,1,5,7,2,3,2,1,14,26,48,1,54
37f1cf47,37,18,22,13,2,18,37,19,21,8,13,25,62,57,0,119
38699c72,12,4,1,5,6,2,13,11,3,1,2,3,15,8,0,43
38ce1150,48,24,21,21,6,11,41,30,25,2,23,16,64,18,0,94
3902e91b,24,15,11,6,7,10,39,29,14,5,9,18,42,22,1,119
3a58d075,1,1,1,0,0,0,1,1,0,0,0,0,1,0,0,0
3a9c4b7b,56,28,27,22,7,22,31,9,39,10,29,43,99,68,0,130
3aa4a3be,11,7,2,6,3,1,16,15,11,0,11,3,14,14,0,19
3aa74860,0,0,0,0,0,0,0,0,0,0,0,0,0,0,0,0
3ae7e4ea,8,5,5,3,0,6,14,8,4,0,4,4,12,7,0,23
3afeb49f,1,1,0,1,0,0,0,0,0,0,0,0,1,1,0,2
3c16d927,38,22,17,15,6,17,38,21,35,2,33,27,65,40,1,136
3ca6106c,18,13,9,8,1,6,26,20,13,1,12,6,24,5,0,39
3cefcaef,26,16,17,6,3,12,24,12,16,4,12,26,52,32,1,119
3d688b46,23,15,10,12,1,8,19,11,13,3,10,13,36,16,1,74
3d7e48ce,14,10,8,4,2,4,23,19,14,1,13,3,17,10,0,42
3da1b6ed,1,0,1,0,0,0,0,0,0,0,0,0,1,0,0,1
3e42f707,26,17,13,13,0,13,24,11,36,19,17,59,85,171,0,175
3e8bb8ce,0,0,0,0,0,0,0,0,0,0,0,0,0,0,0,2
3ecc11d8,19,12,11,8,0,9,21,12,12,5,7,53,72,73,0,126
3ed84b2c,0,0,0,0,0,0,1,1,0,0,0,0,0,1,0,2
3ee0dd59,41,22,18,20,3,20,34,14,22,10,12,40,81,39,0,102
3eed9821,5,1,3,2,0,1,2,1,11,6,5,9,14,15,0,36
3f10bd22,27,21,15,11,1,15,22,7,10,3,7,37,64,62,1,172
3fc45c73,22,15,16,6,0,9,27,18,17,7,10,28,50,96,0,159
40449bbd,7,6,4,3,0,1,5,4,8,7,1,23,30,54,2,66
405f267a,18,10,14,3,1,8,26,18,14,1,13,20,38,24,0,98
4112ace5,31,21,10,15,6,11,42,31,17,6,11,18,49,14,0,121
418f8f61,18,11,10,3,5,5,22,17,10,1,9,9,27,12,1,85
41c12f75,61,33,31,21,9,32,56,24,33,3,30,31,92,55,0,160
41f32541,54,28,24,25,5,23,43,20,25,11,14,41,95,70,0,191
41fb0f4e,5,5,1,3,1,3,6,3,8,0,8,2,7,0,0,20
42276181,7,4,3,2,2,3,11,8,10,0,10,0,7,3,0,21
42a028c5,0,0,0,0,0,0,0,0,0,0,0,0,0,0,0,0
43f71e77,11,4,3,5,3,8,22,14,5,1,4,3,14,19,0,44
44150beb,0,0,0,0,0,0,0,0,0,0,0,1,1,0,0,4
4442fbcd,14,7,5,8,1,9,18,9,8,5,3,8,22,12,1,20
452c3055,7,2,2,4,1,4,10,6,7,0,7,1,8,2,0,25
45af8a54,12,6,7,4,1,3,24,21,15,0,15,11,23,10,0,84
45e17712,35,21,20,12,3,15,26,11,24,7,17,26,61,60,0,134
45e304c8,3,1,2,1,0,1,1,0,0,0,0,0,3,0,0,1
4601e194,45,30,22,16,7,24,52,28,21,2,19,49,94,48,0,218
466824fb,39,16,8,27,4,17,60,43,24,6,18,29,68,41,0,174
467bae22,5,1,0,3,2,1,5,4,2,1,1,1,6,1,0,9
46a8347f,18,12,13,5,0,8,12,4,5,0,5,8,26,14,0,21
46bd3a5b,16,9,8,6,2,8,12,4,9,1,8,20,36,31,0,77
4737cebe,9,8,0,6,3,3,8,5,7,2,5,3,12,4,0,60
474ecac8,16,12,12,3,1,7,18,11,21,10,11,33,49,84,1,88
47d493c3,16,12,11,5,0,8,14,6,10,4,6,11,27,16,0,37
487d9b09,28,14,21,5,2,12,21,9,22,8,14,33,61,67,1,92
48e89655,8,6,3,3,2,3,12,9,5,0,5,2,10,1,0,17
4958bfb2,27,20,12,10,5,11,20,9,19,1,18,13,40,27,0,62
49ea92be,6,4,1,3,2,2,13,11,11,0,11,5,11,3,0,27
4a478107,18,10,7,9,2,8,36,28,17,0,17,11,29,11,0,97
4a633cfe,19,9,14,4,1,9,15,6,16,8,8,14,33,40,0,77
4a895384,8,4,5,3,0,7,14,7,6,3,3,13,21,38,0,47
4aa253fd,2,1,0,2,0,1,2,1,1,0,1,0,2,3,0,7
4ac7608e,11,7,7,3,1,5,11,6,16,9,7,20,31,49,1,70
4accb7e0,10,6,6,4,0,5,16,11,8,1,7,7,17,10,0,43
4b3c863f,1,1,1,0,0,0,3,3,0,0,0,0,1,6,0,4
4b5e7e90,37,18,26,9,2,14,31,17,14,8,6,24,61,68,0,60
4bd414c1,22,15,19,3,0,13,18,5,32,22,10,22,44,146,2,175
4c0a6a48,19,9,10,6,3,8,22,14,8,1,7,10,29,9,0,42
4c2e9442,11,9,3,7,1,3,14,11,13,3,10,2,13,34,0,57
4c5b14d2,9,3,1,5,3,4,12,8,8,0,8,17,26,11,0,55
4cee5954,45,25,23,19,3,19,35,16,30,8,22,39,84,72,0,154
4d1666ff,27,15,14,11,2,10,24,14,24,16,8,40,67,104,0,186
4d224fe8,84,49,50,30,4,33,73,40,50,17,33,70,154,62,0,226
4d8cd038,0,0,0,0,0,0,0,0,0,0,0,0,0,0,0,1
4dbd0916,30,17,9,17,4,11,24,13,22,1,21,11,41,10,0,73
4e219ad2,20,10,8,6,6,10,41,31,12,0,12,8,28,8,0,85
4f28a6ff,36,21,23,10,3,19,28,9,26,12,14,33,69,71,1,164
506daeac,7,2,4,2,1,3,7,4,6,2,4,3,10,5,0,14
518f2234,4,3,1,2,1,1,3,2,1,1,0,1,5,1,0,3
51a3c4c8,29,17,19,10,0,18,23,5,30,15,15,36,65,128,2,126
51e3954c,25,14,14,11,0,11,20,9,11,6,5,25,50,26,0,95
52611641,8,4,2,3,3,0,3,3,5,3,2,12,20,8,0,37
529f49ab,7,4,4,3,0,5,8,3,4,1,3,2,9,1,0,17
532e1e4f,17,11,10,5,2,11,18,7,33,25,8,23,40,111,1,201
5343eb4e,12,7,1,4,7,3,8,5,5,0,5,3,15,2,0,46
53520a67,55,29,25,25,5,22,52,30,39,7,32,51,106,45,0,143
54073b28,17,5,4,8,5,8,18,10,6,0,6,4,21,1,0,35
540ec57b,19,11,10,7,2,8,28,20,20,1,19,9,28,8,0,31
5496cc91,28,17,12,10,6,9,35,26,26,1,25,21,49,9,0,96
55126f3b,64,42,22,31,11,28,98,70,35,6,29,36,100,40,0,222
555f3a0b,55,31,40,11,4,37,61,24,23,10,13,36,91,73,0,151
56cafd0a,0,0,0,0,0,0,0,0,2,2,0,3,3,11,0,10
57be54ec,3,2,0,2,1,2,8,6,4,0,4,2,5,16,0,27
58a9a4d9,34,22,13,15,6,19,53,34,15,0,15,15,49,9,0,102
58afe001,64,39,22,35,7,23,80,57,40,5,35,42,106,28,0,204
5976f83e,31,16,23,6,2,18,32,14,25,4,21,10,41,24,1,108
59b7d823,9,7,6,3,0,3,8,5,8,1,7,4,13,24,0,41
5a36f180,9,7,5,2,2,3,10,7,11,0,11,8,17,5,0,54
5a626448,21,12,6,8,7,14,35,21,20,3,17,11,32,16,0,162
5ab0ea87,63,35,21,29,13,27,76,49,27,4,23,53,116,18,2,182
5acc4a10,20,10,14,6,0,8,18,10,7,1,6,20,40,23,0,56
5b28b2f6,34,18,23,11,0,13,39,26,24,1,23,21,55,26,1,101
5c4dc0ff,4,2,2,1,1,0,9,9,3,1,2,0,4,3,0,11
5c7845f6,23,16,15,8,0,8,14,6,20,13,7,12,35,46,0,123
5c96b017,50,29,21,22,7,14,45,31,28,2,26,29,79,20,0,158
5ca20b7a,15,12,7,5,3,6,18,12,6,2,4,6,21,13,0,25
5ce0b5ba,5,2,1,4,0,1,5,4,2,0,2,5,10,7,0,11
5cec2487,6,3,2,2,2,1,3,2,1,1,0,2,8,6,0,10
5db04597,26,17,21,4,1,12,26,14,18,6,12,35,61,27,0,113
5dcf3e90,1,0,1,0,0,1,2,1,0,0,0,0,1,7,7,34
5dd16ace,1,0,0,1,0,1,2,1,0,0,0,2,3,0,0,9
5e95c000,0,0,0,0,0,0,0,0,0,0,0,0,0,1,0,0
5eebbfdf,22,12,10,7,5,5,25,20,21,4,17,26,48,15,1,85
6025fab1,37,23,18,16,3,13,36,23,14,2,12,48,85,14,1,185
603116a7,25,21,11,6,8,11,24,13,13,1,12,10,35,15,0,66
60359288,15,10,10,4,1,9,10,1,15,7,8,15,30,37,0,42
608bcb88,0,0,0,0,0,0,0,0,0,0,0,0,0,0,0,0
608f2092,21,10,15,5,1,8,18,10,15,4,11,15,36,27,0,96
61220da2,14,6,3,6,5,5,14,9,2,0,2,13,27,4,0,47
61bb7498,0,0,0,0,0,0,0,0,0,0,0,0,0,2,0,10
61bd33d0,13,8,6,3,4,3,12,9,19,0,19,12,25,7,0,89
625c144a,0,0,0,0,0,0,0,0,0,0,0,0,0,0,1,1
6265208f,27,14,6,15,6,8,28,20,26,3,23,15,42,58,1,118
636eae97,31,16,11,14,6,15,42,27,15,1,14,5,36,3,0,53
63b0ca6b,11,5,3,4,4,5,11,6,7,2,5,3,14,19,0,43
63d17038,1,1,1,0,0,0,0,0,0,0,0,1,2,4,0,7
63f04c6c,35,19,16,11,8,11,31,20,21,5,16,34,69,47,1,101
64a76620,1,1,0,1,0,0,0,0,1,0,1,0,1,0,0,1
64e8ed6d,0,0,0,0,0,0,1,1,0,0,0,0,0,0,0,0
6583a8a9,4,2,2,2,0,3,4,1,5,2,3,4,8,9,0,11
67669ce7,1,1,1,0,0,1,1,0,0,0,0,0,1,6,0,12
683788fd,0,0,0,0,0,0,1,1,1,0,1,0,0,0,0,1
685857dc,15,8,6,7,2,5,13,8,6,3,3,7,22,9,0,57
68796d61,7,5,5,0,2,0,5,5,5,0,5,4,11,6,0,22
689c9cf4,19,10,12,5,2,8,14,6,9,1,8,18,37,47,0,55
6922f806,15,6,2,4,9,3,17,14,18,2,16,1,16,10,1,52
697295b1,11,9,7,4,0,7,14,7,12,6,6,23,34,54,0,93
69c5633e,0,0,0,0,0,0,1,1,1,0,1,2,2,1,0,2
6a99e0b1,11,7,0,4,7,2,14,12,13,1,12,5,16,22,0,56
6c4776b1,1,0,1,0,0,1,1,0,1,0,1,0,1,22,6,31
6c7762c3,40,22,22,14,4,12,29,17,21,6,15,19,59,24,1,64
6c811eb7,16,10,4,9,3,7,25,18,14,1,13,2,18,2,0,76
6ce1f46f,42,22,15,15,12,11,44,33,26,6,20,15,57,10,3,125
6d8f8441,24,10,14,7,3,14,27,13,13,1,12,14,38,27,0,48
6e36226f,1,0,0,1,0,0,1,1,0,0,0,0,1,3,0,1
6e4df551,9,6,2,4,3,2,12,10,13,2,11,7,16,6,0,49
6eaed4eb,43,32,36,7,0,21,35,14,38,24,14,51,94,149,1,160
6f4c734d,32,17,13,18,1,14,31,17,16,7,9,27,59,33,1,123
6f51e382,0,0,0,0,0,0,2,2,0,0,0,0,0,12,2,46
6f5f82c0,76,43,45,20,11,27,64,37,25,4,21,23,99,42,0,134
70d74ece,8,6,4,2,2,5,15,10,9,2,7,8,16,24,0,69
7111d552,32,22,14,10,8,11,43,32,28,0,28,7,39,4,0,91
719384c1,15,9,7,7,1,4,16,12,13,3,10,22,37,21,0,74
71b47ab9,19,10,1,14,4,2,23,21,18,1,17,6,25,8,0,78
72a84002,42,25,24,15,3,16,37,21,28,15,13,32,74,119,0,109
72a99e38,16,10,5,9,2,4,22,18,14,0,14,11,27,8,0,66
72b07a9c,3,2,2,1,0,3,5,2,2,2,0,7,10,3,0,16
7329018e,43,29,15,22,6,12,41,29,23,5,18,39,82,34,1,183
7460ca0d,65,40,32,23,10,33,81,48,35,8,27,45,110,21,3,226
74aa6ab7,2,1,2,0,0,0,2,2,1,0,1,2,4,2,1,4
74d9a90b,1,0,0,0,1,0,0,0,0,0,0,0,1,0,0,1
75645f0e,1,1,0,0,1,1,8,7,7,2,5,3,4,9,0,26
76d679c7,12,7,6,6,0,4,6,2,7,2,5,6,18,25,1,33
77e39b04,4,2,0,3,1,2,5,3,4,0,4,1,5,2,0,32
788be7f9,2,1,1,0,1,0,1,1,0,0,0,1,3,0,0,7
78c40e94,11,3,5,6,0,2,13,11,5,1,4,9,20,5,0,20
79300479,1,0,0,1,0,1,2,1,1,0,1,1,2,0,0,10
7a538238,33,22,23,7,3,19,36,17,15,6,9,15,48,39,0,80
7b456af7,0,0,0,0,0,0,1,1,0,0,0,0,0,0,1,6
7b5ab7f2,29,19,12,12,5,6,23,17,20,0,20,17,46,6,0,140
7c388b20,42,24,24,12,6,14,46,32,35,6,29,34,76,43,0,149
7c4243d4,46,29,18,24,4,20,47,27,11,2,9,14,60,23,1,136
7dcf86f6,11,3,2,7,2,2,23,21,25,2,23,16,27,21,0,113
7e98cff1,4,0,0,3,1,1,7,6,3,0,3,5,9,5,0,23
7f203b54,11,5,6,5,0,5,7,2,1,0,1,10,21,23,0,31
7f4c7c9f,32,22,26,6,0,21,35,14,22,2,20,27,59,54,0,124
80153344,2,0,1,1,0,2,4,2,1,1,0,0,2,6,0,3
808d48f3,10,6,4,6,0,7,9,2,7,1,6,6,16,8,0,21
81442ecb,62,42,34,20,8,23,41,18,23,2,21,23,85,30,1,160
81d5c497,8,3,0,4,4,2,9,7,1,0,1,2,10,2,0,19
81f0781e,24,15,8,10,6,7,34,27,17,4,13,15,39,26,0,92
82803509,5,3,4,1,0,2,15,13,7,0,7,1,6,1,0,7
82e9b89d,6,3,2,2,2,2,14,12,5,1,4,1,7,9,0,26
833fb62e,13,9,3,8,2,4,11,7,11,1,10,10,23,2,0,54
84399660,13,9,3,5,5,4,18,14,4,0,4,2,15,4,0,21
8455ad90,15,11,8,4,3,3,31,28,12,0,12,2,17,0,0,59
850c0a0d,45,26,31,11,3,27,54,27,36,11,25,69,114,73,1,245
85bed4ee,3,3,1,2,0,1,6,5,7,0,7,2,5,0,0,41
868ce848,1,1,0,0,1,1,3,2,1,0,1,3,4,6,0,9
8696bc90,12,8,5,5,2,2,12,10,6,0,6,5,17,6,0,55
877f31c2,4,3,1,2,1,0,4,4,1,0,1,1,5,1,0,14
88050721,27,17,13,13,1,10,29,19,20,5,15,18,45,9,1,97
88a359d4,3,3,0,1,2,1,5,4,3,0,3,0,3,3,0,22
88d91621,42,25,13,26,3,8,22,14,22,5,17,22,64,24,2,103
8970907e,25,12,12,8,5,8,49,41,21,1,20,25,50,15,0,152
89cbc961,12,8,7,5,0,7,11,4,7,5,2,8,20,42,1,50
89d1e9fa,1,0,1,0,0,1,1,0,0,0,0,0,1,0,0,4
89f951b5,32,18,18,10,4,12,41,29,19,4,15,26,58,29,1,157
8a6daac3,6,4,4,1,1,5,8,3,2,0,2,2,8,1,0,8
8aafd64f,8,4,1,6,1,4,17,13,3,0,3,5,13,2,0,63
8abefbcf,1,1,0,1,0,0,0,0,1,0,1,0,1,0,0,3
8b625720,11,9,9,2,0,6,14,8,9,6,3,11,22,32,0,20
8c2c48a9,2,2,1,1,0,1,6,5,7,3,4,8,10,4,0,17
8c3c640c,30,17,14,12,4,10,31,21,30,5,25,15,45,17,0,127
8cfc2f69,7,4,1,4,2,1,16,15,7,0,7,2,9,8,0,35
8d47bb39,12,6,6,6,0,6,11,5,16,4,12,27,39,58,0,67
8d6a9c93,3,0,2,1,0,1,1,0,2,0,2,1,4,7,0,10
8db394aa,54,30,36,17,1,14,30,16,14,4,10,47,101,75,3,129
8e010ff4,5,3,1,4,0,2,14,12,3,0,3,5,10,1,0,31
8e088e04,13,6,7,3,3,6,13,7,12,1,11,10,23,21,0,46
8e48dc61,35,23,15,16,4,15,30,15,19,5,14,25,60,35,1,170
8e92be30,9,5,0,3,6,3,8,5,17,1,16,3,12,7,0,50
8f29e08b,0,0,0,0,0,0,0,0,0,0,0,0,0,1,0,5
8f3565b3,20,12,2,11,7,4,15,11,17,4,13,2,22,17,1,55
8f5e92a6,15,6,10,4,1,2,17,15,15,0,15,7,22,4,0,40
8f898ba8,9,8,1,7,1,2,8,6,2,1,1,4,13,14,0,24
8f8c6934,2,2,2,0,0,1,3,2,0,0,0,1,3,12,0,37
8fae77ea,0,0,0,0,0,0,2,2,2,0,2,2,2,8,1,21
9038c2a1,9,3,5,2,2,4,16,12,6,1,5,10,19,4,0,23
90f83973,10,7,7,3,0,7,13,6,5,1,4,8,18,10,0,30
92d38e6c,46,24,34,10,2,20,30,10,38,17,21,62,108,125,2,161
93090f69,32,20,18,12,2,14,21,7,29,20,9,29,61,86,0,126
933e8c8a,0,0,0,0,0,0,0,0,2,0,2,0,0,2,0,3
94084f83,0,0,0,0,0,0,0,0,0,0,0,0,0,0,0,2
954c26c9,0,0,0,0,0,0,0,0,0,0,0,1,1,1,0,2
958d67bb,1,1,0,1,0,0,0,0,0,0,0,0,1,0,0,3
963829d0,51,30,25,21,5,21,77,56,32,2,30,17,68,19,0,153
967f34d3,0,0,0,0,0,0,0,0,0,0,0,0,0,7,3,17
968a1c2f,1,1,0,1,0,1,2,1,1,0,1,0,1,0,0,7
974322dc,27,15,14,10,3,11,19,8,11,1,10,17,44,19,0,33
97572117,38,23,14,19,5,15,30,15,16,2,14,22,60,42,0,126
97852360,2,0,2,0,0,2,4,2,0,0,0,2,4,19,0,34
978cd030,39,24,31,8,0,17,29,12,32,18,14,52,91,98,0,128
9939e168,61,36,27,23,11,24,67,43,27,9,18,23,84,38,0,205
9970da54,0,0,0,0,0,0,0,0,0,0,0,0,0,0,0,0
99bebd12,2,2,0,2,0,0,2,2,0,0,0,1,3,2,0,7
9a64e67e,34,20,25,8,1,9,19,10,35,24,11,36,70,87,1,139
9d2a3d5f,6,4,2,3,1,4,7,3,3,0,3,2,8,4,0,19
9d66fbe3,7,4,1,4,2,2,11,9,8,0,8,4,11,13,1,40
9f0ea33f,0,0,0,0,0,0,1,1,0,0,0,0,0,13,2,40
9f323c71,28,17,12,10,6,10,25,15,12,1,11,12,40,38,0,86
9f351459,19,14,6,7,6,3,29,26,12,0,12,9,28,9,0,83
9f8e9423,22,14,16,5,1,10,19,9,26,18,8,36,58,114,2,150
9f9e1b9c,2,0,1,1,0,1,3,2,0,0,0,0,2,0,0,1
a01c3d54,0,0,0,0,0,0,0,0,0,0,0,2,2,17,1,51
a039d52e,1,1,0,1,0,0,1,1,0,0,0,0,1,0,0,0
a08b974a,36,24,12,16,8,13,37,24,33,1,32,19,55,30,1,117
a0b4bb3e,13,9,5,5,3,2,14,12,7,1,6,2,15,2,0,48
a10361d2,5,4,2,2,1,1,10,9,5,0,5,8,13,2,0,19
a1216563,12,7,3,8,1,3,15,12,16,1,15,6,18,9,0,50
a190d597,1,0,1,0,0,1,3,2,0,0,0,0,1,2,0,2
a300ac7e,6,2,3,3,0,2,10,8,6,1,5,2,8,5,0,75
a39bb753,3,2,1,2,0,0,3,3,3,0,3,3,6,0,0,18
a4971d84,61,39,31,26,4,26,34,8,24,11,13,42,103,96,0,236
a4995f48,0,0,0,0,0,0,2,2,0,0,0,3,3,29,3,37
a4b00319,88,54,47,35,6,46,72,26,30,4,26,39,127,61,0,224
a4fe8cda,0,0,0,0,0,0,1,1,0,0,0,1,1,0,0,2
a55d8df5,32,18,14,14,4,10,35,25,26,0,26,11,43,8,0,91
a56da3ba,36,22,17,16,3,19,35,16,19,5,14,15,51,50,0,97
a60823a4,23,15,10,8,5,15,22,7,10,4,6,16,39,23,1,48
a6154613,11,7,0,4,7,3,12,9,7,0,7,5,16,13,0,38
a62b4888,50,30,20,23,7,24,65,41,27,6,21,17,67,14,0,114
a6951bf8,19,14,4,12,3,8,19,11,8,2,6,21,40,11,1,65
a6de370d,16,9,9,6,1,3,21,18,18,0,18,13,29,5,0,157
a75b4071,2,2,1,0,1,0,1,1,0,0,0,5,7,3,0,7
a7a9d95a,6,3,1,2,3,3,7,4,8,0,8,9,15,6,0,31
a7f00c8c,3,3,2,1,0,1,3,2,3,0,3,4,7,7,0,9
a83d8b0c,21,14,10,10,1,9,26,17,12,0,12,9,30,6,0,70
a8542814,12,7,5,6,1,7,13,6,7,2,5,14,26,8,0,59
a8fbae1d,42,21,32,8,2,19,36,17,39,14,25,59,101,112,0,150
a98f3cbf,7,6,5,2,0,5,13,8,3,0,3,3,10,2,0,21
a9dc785c,0,0,0,0,0,0,1,1,0,0,0,0,0,3,1,7
aa0ac32d,22,13,17,5,0,10,18,8,23,15,8,36,58,97,1,111
aa677a35,19,9,8,8,3,8,30,22,14,1,13,22,41,15,0,130
aa7da569,2,1,2,0,0,1,2,1,1,1,0,0,2,0,0,3
aad53e64,10,5,6,1,3,5,24,19,10,1,9,16,26,8,0,103
ab99e4a0,2,2,1,1,0,0,1,1,0,0,0,1,3,0,0,2
abb3bb95,9,5,3,2,4,1,7,6,11,3,8,5,14,15,0,38
ac295d9e,4,3,4,0,0,2,4,2,0,0,0,0,4,16,2,59
ac7e7b1c,8,5,2,4,2,3,13,10,0,0,0,4,12,3,0,23
ac8b2421,20,10,16,3,1,8,13,5,9,1,8,5,25,21,0,44
ad178594,6,3,5,1,0,4,6,2,0,0,0,3,9,13,0,10
ad1ffcfd,18,8,8,7,3,8,24,16,14,7,7,14,32,25,1,68
ad6df2d5,13,8,7,4,2,7,13,6,5,1,4,11,24,5,0,54
adfc9123,16,11,11,5,0,9,12,3,9,4,5,26,42,46,0,88
ae86d473,8,2,2,2,4,0,8,8,15,2,13,2,10,9,0,29
aed746df,39,29,18,13,8,15,48,33,20,3,17,19,58,14,0,107
afafac57,1,1,1,0,0,1,1,0,0,0,0,0,1,0,0,6
afdc14d7,1,0,1,0,0,0,2,2,0,0,0,1,2,0,0,2
b05e2dbd,59,33,40,13,6,33,68,35,22,3,19,38,97,62,1,181
b0616e3d,12,8,6,5,1,6,12,6,5,2,3,9,21,7,0,26
b0fce72c,28,14,8,16,4,12,50,38,28,8,20,27,55,35,1,116
b14d0c5d,9,3,6,3,0,4,9,5,6,4,2,16,25,28,0,40
b14f755d,64,41,42,17,5,35,84,49,27,8,19,36,100,33,3,195
b19db005,14,9,4,9,1,6,17,11,10,0,10,9,23,3,1,62
b1e5bbec,0,0,0,0,0,0,0,0,0,0,0,0,0,1,0,1
b233e8e4,45,21,35,9,1,24,44,20,29,17,12,36,81,100,2,166
b2d0ec1b,70,36,30,30,10,32,92,60,46,2,44,22,92,19,0,174
b39a793e,4,3,1,2,1,0,2,2,5,0,5,2,6,2,0,5
b3b62f94,23,15,15,8,0,15,24,9,18,12,6,22,45,78,0,75
b3dc6eca,11,7,7,4,0,4,13,9,17,13,4,44,55,85,0,130
b3f97139,1,1,1,0,0,1,2,1,0,0,0,1,2,0,0,0
b418dbd4,34,19,9,19,6,7,22,15,30,1,29,15,49,20,0,43
b4a014b1,22,13,17,4,1,8,16,8,35,27,8,31,53,114,1,160
b51b1b9c,21,18,12,3,6,8,24,16,20,0,20,15,36,12,1,80
b5dd3469,23,15,12,10,1,5,19,14,9,3,6,19,42,12,1,89
b6e50615,24,19,14,5,5,10,24,14,14,0,14,11,35,29,0,109
b742cc0d,27,16,18,8,1,12,22,10,19,5,14,40,67,74,3,86
b7c04927,33,17,16,17,0,18,30,12,26,8,18,14,47,54,1,66
b7c99b9b,20,12,13,6,1,14,31,17,25,13,12,37,57,104,0,107
b7ca5c51,17,11,9,5,3,6,17,11,32,27,5,59,76,132,3,162
b7d7f3bf,16,9,3,6,7,7,30,23,9,0,9,15,31,11,0,58
b7f2edff,6,3,1,4,1,2,5,3,6,2,4,6,12,11,0,23
b86a64b2,30,16,21,8,1,12,21,9,24,15,9,43,73,113,0,101
b8a642fc,12,7,4,4,4,3,17,14,8,0,8,10,22,3,0,65
b8c1de25,53,37,18,33,2,15,37,22,17,0,17,25,78,21,1,129
b92b456a,1,0,1,0,0,1,1,0,0,0,0,0,1,0,0,2
ba3ca78f,0,0,0,0,0,0,1,1,0,0,0,0,0,7,0,13
ba5004e1,59,39,29,23,7,30,81,51,43,2,41,31,90,42,0,155
ba5a9545,19,12,7,9,3,9,26,17,6,0,6,11,30,8,0,108
ba71d071,8,4,6,2,0,3,5,2,19,13,6,16,24,50,0,34
bb4b1242,21,15,6,7,8,9,22,13,11,0,11,6,27,5,0,57
bb6c6331,1,0,0,1,0,1,5,4,1,0,1,0,1,0,0,9
bba30585,1,0,1,0,0,1,2,1,1,1,0,2,3,5,0,4
bbc19252,55,26,28,24,3,23,51,28,38,9,29,43,98,36,2,208
bbf5c11b,15,9,4,4,7,7,22,15,14,2,12,15,30,25,0,80
bc61cc65,20,10,9,6,5,10,16,6,12,0,12,15,35,8,1,90
bc6f5f06,4,3,2,2,0,1,1,0,5,4,1,6,10,34,0,25
bdb624a3,8,2,3,4,1,2,7,5,4,0,4,5,13,7,0,47
bdc14559,18,12,10,8,0,5,15,10,7,1,6,11,29,18,0,34
be170419,23,12,16,7,0,10,15,5,19,14,5,32,55,110,0,122
be3a0121,5,4,4,0,1,1,3,2,3,0,3,2,7,7,0,22
bece776f,45,23,9,22,14,7,43,36,31,2,29,8,53,2,0,103
bf12926c,9,4,3,5,1,6,16,10,15,0,15,11,20,6,0,50
bfb15d99,0,0,0,0,0,0,0,0,0,0,0,0,0,1,1,3
c00097d2,14,7,8,3,3,8,18,10,24,16,8,35,49,52,1,94
c05dfb74,20,7,4,10,6,6,24,18,15,0,15,11,31,4,0,91
c14bc029,57,34,27,23,7,30,59,29,35,2,33,19,76,43,0,109
c2111b45,11,6,7,3,1,7,18,11,21,11,10,13,24,55,0,59
c261b5dd,2,2,2,0,0,2,4,2,0,0,0,1,3,0,0,4
c2cfbfc9,4,2,1,3,0,1,2,1,2,0,2,4,8,0,0,11
c46736ab,18,10,8,7,3,10,26,16,12,4,8,14,32,13,0,45
c4b888df,68,43,36,25,7,33,60,27,37,12,25,49,117,89,0,171
c4dce677,8,4,4,4,0,3,18,15,5,0,5,8,16,9,0,24
c4f5eb61,0,0,0,0,0,0,1,1,1,1,0,0,0,1,0,4
c5fa58ea,38,18,19,18,1,13,53,40,23,6,17,31,69,38,1,132
c67cd65c,34,19,26,7,1,12,29,17,22,11,11,46,80,106,3,131
c77a8043,27,13,9,12,6,10,32,22,24,5,19,12,39,25,0,89
c78b352d,47,27,32,10,5,21,43,22,24,6,18,42,89,63,1,125
c90977db,33,19,12,14,7,12,55,43,18,0,18,15,48,9,0,139
c960cfdb,0,0,0,0,0,0,0,0,0,0,0,0,0,1,0,1
c966fce1,0,0,0,0,0,0,1,1,2,0,2,0,0,0,0,5
c997b942,1,1,1,0,0,0,2,2,0,0,0,1,2,0,0,4
c9cb972b,1,1,1,0,0,1,2,1,1,0,1,0,1,16,2,28
c9e39d91,59,31,23,27,9,16,65,49,27,2,25,32,91,34,0,162
cac2537b,28,12,8,16,4,10,36,26,8,2,6,21,49,14,0,120
cb574619,58,40,34,23,1,24,52,28,42,11,31,37,95,77,0,141
cbdf7d5c,0,0,0,0,0,0,0,0,1,0,1,0,0,0,0,0
ccaa5728,6,4,2,2,2,1,14,13,6,0,6,3,9,3,0,30
cce181df,46,29,21,20,5,18,39,21,17,6,11,19,65,16,1,103
cd9b37a3,0,0,0,0,0,0,1,1,0,0,0,0,0,0,0,3
cda0b317,0,0,0,0,0,0,1,1,1,0,1,0,0,11,2,30
cde52ef5,0,0,0,0,0,0,1,1,0,0,0,0,0,18,0,25
ced26057,7,4,5,2,0,4,6,2,4,2,2,8,15,1,0,22
d080ed5e,61,36,14,36,11,18,45,27,36,8,28,32,93,26,0,174
d2110326,16,8,10,6,0,8,12,4,28,21,7,27,43,102,1,112
d2aea9ac,1,0,0,1,0,0,2,2,2,0,2,1,2,4,0,10
d2ed99b4,0,0,0,0,0,0,0,0,0,0,0,0,0,0,0,1
d38fdf53,37,17,23,12,2,14,23,9,10,2,8,35,72,14,2,86
d3b888e3,2,0,1,1,0,1,6,5,1,0,1,6,8,0,0,18
d49f3e6b,47,31,13,27,7,10,49,39,37,2,35,19,66,21,0,93
d4cb83cc,31,19,17,11,3,7,20,13,14,3,11,31,62,43,0,115
d4ef9ac5,4,0,4,0,0,0,2,2,10,1,9,7,11,12,0,47
d637fc22,38,16,21,14,3,16,50,34,30,14,16,29,67,40,1,139
d66b9872,9,8,3,3,3,3,17,14,11,0,11,7,16,2,0,35
d70ce98e,18,10,3,9,6,6,17,11,12,0,12,6,24,0,2,66
d733aa38,15,8,6,5,4,8,29,21,12,0,12,16,31,13,0,117
d83bbc54,52,31,21,29,2,22,55,33,33,13,20,47,99,69,0,160
d858d079,0,0,0,0,0,0,0,0,0,0,0,0,0,0,0,0
d87e2cae,3,1,0,3,0,1,3,2,3,1,2,0,3,8,0,30
db001fa9,92,48,63,28,1,43,85,42,30,5,25,41,133,74,0,178
db750822,4,1,2,0,2,1,6,5,3,0,3,3,7,2,0,10
dc1c2fce,47,31,21,20,6,9,51,42,48,3,45,18,65,27,0,110
dc56efc9,0,0,0,0,0,0,0,0,0,0,0,0,0,0,0,0
dd672e1f,20,13,13,7,0,7,10,3,18,12,6,11,31,71,0,81
ddd5348b,9,3,3,2,4,2,7,5,7,1,6,3,12,4,0,31
de39485a,27,15,14,6,7,15,34,19,24,0,24,17,44,16,1,151
debc6b55,5,3,0,2,3,0,3,3,3,1,2,2,7,4,0,16
dee86451,19,12,7,11,1,5,21,16,11,3,8,11,30,14,1,95
def69cd0,24,12,14,8,2,11,34,23,20,3,17,23,47,22,0,141
df69b544,37,22,10,18,9,12,40,28,20,1,19,12,49,11,0,100
df8b52a5,91,52,62,25,4,43,78,35,33,6,27,61,152,102,2,165
e08647d6,4,2,1,2,1,1,10,9,9,2,7,1,5,6,0,28
e1846dde,0,0,0,0,0,0,1,1,0,0,0,3,3,5,1,16
e208bcc8,5,4,2,1,2,3,4,1,2,0,2,3,8,0,0,7
e2716bd0,19,12,2,14,3,8,21,13,14,1,13,13,32,8,2,96
e29d1111,43,21,29,10,4,24,52,28,21,1,20,29,72,47,0,128
e4346678,1,0,1,0,0,1,3,2,0,0,0,0,1,17,3,50
e49ce451,14,8,8,4,2,5,9,4,5,2,3,10,24,9,0,25
e54bd0a2,39,18,18,16,5,16,42,26,28,8,20,37,76,42,0,156
e6bc67d7,18,12,8,7,3,10,45,35,24,1,23,8,26,7,0,94
e6eadfb8,2,0,1,0,1,0,1,1,0,0,0,0,2,0,0,4
e778654a,59,26,19,32,8,11,41,30,53,17,36,26,85,32,1,145
e7986081,0,0,0,0,0,0,1,1,0,0,0,1,1,0,0,2
e7ab4179,24,14,11,12,1,12,22,10,8,6,2,13,37,51,1,70
e7f4603c,13,7,4,6,3,6,12,6,12,0,12,10,23,4,1,60
e82d2807,0,0,0,0,0,0,3,3,2,1,1,2,2,6,0,7
e897d8ba,24,18,5,7,12,6,22,16,24,1,23,7,31,29,0,128
e8a0d2f7,0,0,0,0,0,0,0,0,0,0,0,1,1,0,0,1
e9ada8cf,5,5,3,2,0,2,3,1,2,0,2,3,8,3,1,14
e9fbcc21,0,0,0,0,0,0,2,2,0,0,0,1,1,0,0,2
ea6a7ab4,2,1,0,1,1,2,8,6,1,0,1,0,2,0,0,7
ea83bfa6,1,0,1,0,0,1,3,2,0,0,0,2,3,14,0,59
ea9b2ef9,24,11,13,9,2,11,23,12,28,26,2,38,62,130,1,103
ead61f73,27,11,16,9,2,16,32,16,18,2,16,29,56,58,1,58
eb3dd471,21,14,11,7,3,7,39,32,23,1,22,20,41,30,0,107
eb82b6f1,46,30,28,15,3,25,64,39,22,2,20,16,62,14,0,137
ec1a731e,1,1,0,1,0,0,2,2,2,2,0,1,2,5,0,7
ecd8c01e,38,28,12,23,3,12,35,23,22,2,20,22,60,7,0,129
ed3f5f4c,43,28,33,10,0,10,18,8,17,7,10,37,80,92,0,91
ed5c5fa3,30,22,15,12,3,8,24,16,14,1,13,16,46,24,0,107
ed6ea4d9,30,17,12,10,8,6,19,13,21,2,19,22,52,13,0,132
ed9f7cfe,30,17,13,12,5,17,26,9,15,0,15,16,46,18,0,73
ee8508c0,0,0,0,0,0,0,0,0,0,0,0,0,0,6,2,49
ee923664,11,5,9,2,0,3,9,6,8,0,8,9,20,18,0,35
eeba07f8,19,11,5,7,7,6,17,11,10,1,9,8,27,11,0,62
ef322658,25,12,10,11,4,10,25,15,13,3,10,18,43,19,0,118
efaefda0,3,2,0,3,0,1,2,1,1,0,1,2,5,3,0,5
efecd633,25,14,15,7,3,11,31,20,23,8,15,28,53,33,0,75
f090a37a,5,3,1,3,1,4,8,4,0,0,0,1,6,0,0,20
f0da930c,20,7,14,5,1,12,17,5,17,11,6,21,41,65,0,82
f11fe861,26,17,18,8,0,17,31,14,22,14,8,37,63,112,1,97
f127d782,1,1,0,1,0,1,3,2,0,0,0,2,3,7,0,31
f1bed920,16,8,8,5,3,7,23,16,10,1,9,20,36,15,1,66
f28876e5,1,1,0,1,0,1,2,1,0,0,0,0,1,0,0,2
f2a68b97,18,14,14,4,0,10,18,8,16,3,13,19,37,33,0,49
f4c69aa6,14,6,5,7,2,5,10,5,16,1,15,5,19,4,1,20
f520049f,0,0,0,0,0,0,1,1,8,6,2,6,6,12,0,23
f6798fc3,1,1,1,0,0,0,2,2,0,0,0,0,1,12,2,31
f681a8ef,10,6,5,5,0,3,10,7,15,1,14,12,22,5,0,43
f6ac68c1,40,25,32,7,1,21,34,13,33,19,14,42,82,110,0,156
f6f6b6e8,21,14,14,7,0,8,11,3,15,10,5,46,67,100,0,90
f7c12fbf,23,13,17,6,0,8,20,12,19,14,5,27,50,102,3,124
f7c491f1,6,3,6,0,0,4,6,2,5,4,1,12,18,33,0,22
f7dc2ae5,30,16,21,7,2,18,22,4,12,5,7,15,45,63,0,107
f8eca1b6,11,3,0,8,3,4,15,11,11,0,11,2,13,14,0,39
f934c5c9,0,0,0,0,0,0,0,0,0,0,0,0,0,0,0,0
faed84db,38,22,16,16,6,16,54,38,33,11,22,26,64,54,0,159
fb5d47b3,55,34,22,24,9,21,40,19,26,4,22,30,85,47,1,61
fbd6378b,30,17,20,10,0,10,16,6,21,13,8,39,69,90,0,129
fce521d7,1,1,0,0,1,0,0,0,1,0,1,0,1,1,0,1
fd01216a,2,0,0,2,0,0,0,0,0,0,0,0,2,0,0,2
fd47b4f2,5,2,3,2,0,3,4,1,2,1,1,7,12,23,1,18
fd51b456,61,37,30,22,9,22,52,30,14,1,13,19,80,31,1,120
fd771f95,8,4,2,3,3,1,6,5,2,0,2,6,14,7,0,39
fe05804b,21,12,15,6,0,11,21,10,18,8,10,35,56,91,0,117
fea23125,0,0,0,0,0,0,1,1,0,0,0,0,0,2,0,2
fed17f5a,41,24,14,24,3,19,52,33,35,11,24,23,64,41,0,148
ffacd3d5,27,15,10,10,7,11,26,15,9,0,9,8,35,15,0,56
