,id,MP,Min,90s,Starts,Compl,Subs,unSub,PPM,onG,onGA,+/-,onxG,onxGA,xG+/-,MinGK,MPGK,StartsGK,90sGK
0,00638016,0,0,0,0,0,0,1,0,0,0,0,0.0,0.0,0.0,2250,25,25,25
1,0118c54c,29,2298,25,26,20,3,5,1,39,29,10,27.5,34.0,-6.4,1170,13,13,13
2,03b5b60c,0,0,0,0,0,0,1,0,0,0,0,0.0,0.0,0.0,1890,21,21,21
3,03bd0bf4,7,301,3,5,1,2,7,0,4,5,-1,4.5,4.2,0.4,2057,23,22,22
4,04a5861a,0,0,0,0,0,0,1,0,0,0,0,0.0,0.0,0.0,3150,35,35,35
5,0515a4cb,25,2095,23,25,21,0,6,0,17,47,-30,23.1,31.3,-8.2,3420,38,38,38
6,0557ff4f,22,1548,17,18,10,4,5,1,15,17,-2,20.9,22.9,-2.0,90,1,1,1
7,05816e19,33,2175,24,24,12,9,1,1,18,33,-15,21.7,32.2,-10.4,180,2,2,2
8,0589c701,1,14,0,0,0,1,0,0,0,0,0,0.5,0.0,0.5,1530,17,17,17
9,0630eb63,17,681,7,7,5,10,10,1,5,11,-6,7.0,11.8,-4.7,3239,36,36,36
10,0670ee51,1,59,0,1,0,0,7,1,0,1,-1,0.8,0.2,0.6,1890,21,21,21
11,06c48679,24,2010,22,23,19,1,6,0,11,30,-19,14.9,35.5,-20.7,270,3,3,3
12,06d51feb,0,0,0,0,0,0,1,0,0,0,0,0.0,0.0,0.0,3330,37,37,37
13,06df8256,20,1762,19,20,19,0,5,1,20,33,-13,22.4,29.0,-6.6,495,6,6,5
14,06f33dc8,33,2260,25,28,10,5,1,0,17,35,-18,20.9,41.7,-20.8,939,11,10,10
15,06f46837,0,0,0,0,0,0,1,0,0,0,0,0.0,0.0,0.0,712,8,7,7
16,07a821e4,2,169,1,2,1,0,2,3,4,1,3,4.5,1.3,3.2,360,4,4,4
17,08082af0,22,1591,17,19,17,3,3,1,27,23,4,21.4,28.8,-7.4,3420,38,38,38
18,083525e5,4,175,1,2,1,2,6,0,0,8,-8,1.3,4.2,-2.9,1530,17,17,17
19,095e4199,15,810,9,8,4,7,1,1,12,15,-3,11.8,13.3,-1.5,90,1,1,1
20,0984c5d5,19,833,9,8,4,11,15,1,4,9,-5,13.4,13.1,0.3,2925,33,32,32
21,09f24df6,2,91,1,1,0,1,0,1,1,1,0,0.9,1.9,-1.0,3330,37,37,37
22,0a63446f,11,571,6,6,6,5,11,1,7,16,-9,6.6,10.2,-3.5,3060,34,34,34
23,0a89e877,22,1824,20,21,17,1,13,0,17,35,-18,21.0,27.9,-6.9,3420,38,38,38
24,0aa874f4,36,3160,35,36,31,0,0,1,38,39,-1,36.0,42.3,-6.3,2736,31,31,30
25,0b0cbe5b,35,2633,29,29,15,6,1,1,41,44,-3,39.5,41.8,-2.3,3420,38,38,38
26,0b4d8274,27,1586,17,19,2,8,1,1,26,16,10,24.8,23.4,1.5,90,1,1,1
27,0bd57eb0,1,1,0,0,0,1,1,3,0,0,0,0.0,0.0,0.0,90,1,1,1
28,0be95d34,29,1343,14,15,6,14,9,1,21,27,-6,23.4,18.6,4.8,680,9,7,7
29,0c291a1a,10,550,6,7,2,3,4,1,8,10,-2,8.6,7.0,1.5,90,1,1,1
30,0d2158d5,26,1803,20,20,15,6,6,1,15,34,-19,19.2,29.8,-10.7,2704,31,31,30
31,0e12089d,11,940,10,10,10,1,25,1,19,17,2,14.7,14.0,0.7,3330,37,37,37
32,0e6bc38c,22,802,8,8,4,14,9,2,17,9,8,19.5,9.4,10.1,3420,38,38,38
33,0e96a5e1,0,0,0,0,0,0,1,0,0,0,0,0.0,0.0,0.0,3330,37,37,37
34,0eb03d5b,16,1377,15,15,14,1,13,1,15,11,4,17.2,22.6,-5.4,1138,14,14,12
35,0ee664db,1,17,0,0,0,1,0,0,1,0,1,0.3,0.1,0.2,225,3,2,2
36,0eeafda5,10,804,8,9,8,1,7,1,10,12,-2,11.2,11.2,0.0,2391,27,27,26
37,0f4c0bad,1,5,0,0,0,1,0,0,1,0,1,0.0,0.0,0.0,0,0,0,0
38,0f52f925,31,2496,27,28,26,3,5,1,36,40,-4,35.2,35.6,-0.4,0,0,0,0
39,0f8418aa,32,2665,29,30,24,2,3,1,42,35,7,28.6,36.5,-7.9,0,0,0,0
40,0f87f8c2,0,0,0,0,0,0,4,0,0,0,0,0.0,0.0,0.0,0,0,0,0
41,0fb21da9,5,313,3,4,3,1,6,1,3,6,-3,1.8,7.2,-5.4,0,0,0,0
42,0fe7f7bc,1,63,0,1,0,0,0,0,1,1,0,0.6,0.8,-0.2,0,0,0,0
43,1040e783,6,357,4,5,3,1,4,0,4,10,-6,2.8,8.2,-5.4,0,0,0,0
44,10650926,18,1293,14,14,9,4,2,0,11,26,-15,9.6,24.8,-15.1,0,0,0,0
45,107f4642,0,0,0,0,0,0,1,0,0,0,0,0.0,0.0,0.0,0,0,0,0
46,11ced928,21,1243,13,13,6,8,6,1,11,16,-5,20.5,19.8,0.7,0,0,0,0
47,132a82f1,2,161,1,1,1,1,2,2,4,1,3,3.6,3.3,0.2,0,0,0,0
48,132bb875,8,713,7,7,7,1,26,1,10,12,-2,10.1,10.6,-0.6,0,0,0,0
49,1467af0d,26,1879,20,23,12,3,2,2,52,18,34,48.2,16.9,31.3,0,0,0,0
50,148e136f,34,2997,33,34,31,0,0,1,53,33,20,50.6,41.4,9.1,0,0,0,0
51,15e1afd5,2,180,2,2,2,0,11,1,1,1,0,1.6,2.0,-0.3,0,0,0,0
52,15e99107,6,162,1,2,0,4,2,0,1,4,-3,1.9,2.6,-0.7,0,0,0,0
53,16324e1d,33,2924,32,33,32,0,0,1,48,48,0,43.3,49.3,-6.0,0,0,0,0
54,166a981d,9,503,5,6,5,3,17,1,6,7,-1,6.4,8.6,-2.2,0,0,0,0
55,16714a62,23,1994,22,22,20,1,10,0,16,32,-16,18.3,28.1,-9.7,0,0,0,0
56,167d5018,27,2426,27,27,26,0,7,0,20,50,-30,26.6,40.6,-14.0,0,0,0,0
57,171bf11d,5,50,0,0,0,5,4,0,0,1,-1,1.5,0.3,1.2,0,0,0,0
58,176674ab,15,465,5,4,1,11,11,0,7,12,-5,6.6,9.5,-2.9,0,0,0,0
59,17f29fb0,1,10,0,0,0,1,3,0,1,1,0,0.2,0.2,0.0,0,0,0,0
60,19053e31,13,741,8,9,4,4,6,0,5,13,-8,7.7,11.6,-3.9,0,0,0,0
61,19a12bed,16,926,10,9,8,7,9,1,14,9,5,11.6,11.8,-0.2,0,0,0,0
62,19cda00b,30,2324,25,28,12,2,1,2,70,20,50,55.1,25.1,30.0,0,0,0,0
63,19f8e480,25,1986,22,22,21,3,7,1,22,28,-6,23.6,33.2,-9.5,0,0,0,0
64,1a4b9094,29,2242,24,25,20,4,4,1,35,36,-1,33.7,29.5,4.1,0,0,0,0
65,1a6f2a66,6,240,2,3,0,3,4,0,2,5,-3,3.3,2.9,0.4,0,0,0,0
66,1a992676,31,2046,22,22,15,9,1,2,65,26,39,52.3,24.4,27.9,0,0,0,0
67,1ad8cb67,32,2815,31,32,29,0,1,1,54,39,15,32.8,41.9,-9.1,0,0,0,0
68,1b82f8df,18,1298,14,15,10,3,2,1,17,18,-1,15.6,21.3,-5.7,0,0,0,0
69,1bfb6fef,9,633,7,7,6,2,11,1,7,9,-2,7.5,9.1,-1.6,0,0,0,0
70,1c344204,33,2805,31,30,29,3,2,0,24,50,-26,33.3,46.8,-13.5,0,0,0,0
71,1d2d5cc8,31,2735,30,31,29,0,1,1,42,40,2,41.0,35.5,5.5,0,0,0,0
72,1d50130f,0,0,0,0,0,0,1,0,0,0,0,0.0,0.0,0.0,0,0,0,0
73,1ec7e1c5,33,2874,31,32,31,1,1,1,47,42,5,48.4,39.6,8.7,0,0,0,0
74,1ef37668,15,1261,14,14,14,1,1,1,12,14,-2,15.5,14.6,0.9,0,0,0,0
75,1f8c7aa9,17,788,8,8,2,9,4,0,3,17,-14,8.1,13.1,-5.0,0,0,0,0
76,1fe370ba,0,0,0,0,0,0,1,0,0,0,0,0.0,0.0,0.0,0,0,0,0
77,20094685,32,2180,24,25,12,7,6,1,38,24,14,34.3,24.2,10.1,0,0,0,0
78,2054d037,29,1793,19,19,9,10,2,1,29,22,7,26.9,22.8,4.1,0,0,0,0
79,20730eae,24,1287,14,16,0,8,3,1,20,7,13,22.3,12.7,9.6,0,0,0,0
80,20e73fac,34,2425,26,28,13,6,2,1,37,39,-2,35.4,35.9,-0.5,0,0,0,0
81,223f8202,0,0,0,0,0,0,25,0,0,0,0,0.0,0.0,0.0,0,0,0,0
82,22721b88,28,2177,24,24,20,4,4,1,40,34,6,33.1,31.0,2.1,0,0,0,0
83,22a62523,1,3,0,0,0,1,7,3,0,1,-1,0.2,0.5,-0.3,0,0,0,0
84,22bfb57e,25,1029,11,11,2,14,7,1,9,11,-2,12.9,13.5,-0.5,0,0,0,0
85,23593121,12,520,5,5,1,7,0,0,6,11,-5,5.3,8.3,-3.0,0,0,0,0
86,2384dbed,1,8,0,0,0,1,1,1,0,0,0,0.8,0.0,0.8,0,0,0,0
87,23b6ab66,0,0,0,0,0,0,1,0,0,0,0,0.0,0.0,0.0,0,0,0,0
88,23c63b7f,20,1036,11,9,3,11,2,1,10,11,-1,16.5,16.8,-0.3,0,0,0,0
89,242b350c,2,3,0,0,0,2,7,1,0,0,0,0.1,0.0,0.1,0,0,0,0
90,2434f24a,37,3330,37,37,37,0,1,1,33,42,-9,37.9,52.4,-14.5,0,0,0,0
91,243f4a0b,33,2875,31,33,27,0,2,1,28,32,-4,32.4,45.1,-12.8,0,0,0,0
92,244bc2c8,18,747,8,8,0,10,1,1,9,11,-2,10.3,10.8,-0.5,0,0,0,0
93,247accfd,34,2942,32,32,31,2,4,0,24,45,-21,26.8,43.0,-16.2,0,0,0,0
94,249cdcff,2,180,2,2,2,0,30,2,2,1,1,2.9,2.1,0.8,0,0,0,0
95,24eb7ed6,30,926,10,7,2,23,5,1,12,10,2,13.8,13.9,0.0,0,0,0,0
96,2515040a,21,1862,20,20,19,1,6,0,18,29,-11,18.3,31.3,-12.9,0,0,0,0
97,26383ea5,6,495,5,6,5,0,16,1,8,4,4,9.8,4.8,5.1,0,0,0,0
98,26777636,7,216,2,2,0,5,3,0,0,2,-2,2.0,2.9,-1.0,0,0,0,0
99,2677a1de,32,2817,31,32,24,0,0,1,43,34,9,43.8,40.7,3.2,0,0,0,0
100,26975a92,36,3239,36,36,35,0,0,1,42,48,-6,47.8,45.7,2.1,0,0,0,0
101,275e2c51,28,2394,26,27,25,1,8,1,31,32,-1,36.1,32.4,3.7,0,0,0,0
102,276cce2e,36,3240,36,36,36,0,2,0,28,59,-31,40.1,48.8,-8.7,0,0,0,0
103,279ddf6a,36,3240,36,36,36,0,0,1,36,39,-3,35.7,41.0,-5.2,0,0,0,0
104,28129034,12,736,8,7,6,5,3,1,4,12,-8,4.3,17.7,-13.4,0,0,0,0
105,288e1e13,13,1050,11,12,10,1,7,0,11,17,-6,11.1,15.9,-4.8,0,0,0,0
106,28a65a2c,1,90,1,1,1,0,37,1,1,1,0,1.6,2.1,-0.6,0,0,0,0
107,28dabd43,38,3420,38,38,38,0,0,1,57,58,-1,50.0,56.5,-6.5,0,0,0,0
108,29c02c9f,17,918,10,9,7,8,4,2,26,15,11,22.9,12.0,10.9,0,0,0,0
109,29d8ad3f,25,1936,21,25,18,0,0,1,21,23,-2,24.6,28.7,-4.0,0,0,0,0
110,29df114a,0,0,0,0,0,0,1,0,0,0,0,0.0,0.0,0.0,0,0,0,0
111,29ef0f49,28,1444,16,15,9,13,5,1,15,23,-8,16.0,21.4,-5.4,0,0,0,0
112,2a657da0,34,2095,23,24,8,10,1,1,22,22,0,21.9,24.8,-2.9,0,0,0,0
113,2b16cb1a,34,2900,32,34,21,0,0,1,28,29,-1,41.2,41.1,0.2,0,0,0,0
114,2b9b37b2,0,0,0,0,0,0,4,0,0,0,0,0.0,0.0,0.0,0,0,0,0
115,2b9fdeea,33,2613,29,30,16,3,0,1,49,39,10,40.1,34.4,5.8,0,0,0,0
116,2c55fadb,0,0,0,0,0,0,2,0,0,0,0,0.0,0.0,0.0,0,0,0,0
117,2c92d3c0,27,1456,16,15,8,12,9,0,12,17,-5,14.8,18.5,-3.8,0,0,0,0
118,2d22cea7,1,4,0,0,0,1,11,0,0,0,0,0.0,0.0,0.0,0,0,0,0
119,2dee43e1,0,0,0,0,0,0,3,0,0,0,0,0.0,0.0,0.0,0,0,0,0
120,2e0367a6,35,2286,25,25,12,10,0,0,24,33,-9,29.9,33.6,-3.7,0,0,0,0
121,2e52206e,21,1436,16,19,5,2,6,1,16,24,-8,17.6,21.1,-3.5,0,0,0,0
122,2ef637bd,18,950,10,11,7,7,6,2,20,11,9,15.7,15.5,0.1,0,0,0,0
123,2f798b41,0,0,0,0,0,0,3,0,0,0,0,0.0,0.0,0.0,0,0,0,0
124,2f8f43f3,7,407,4,5,1,2,7,0,2,8,-6,2.8,9.0,-6.2,0,0,0,0
125,2f965a72,21,1890,21,21,21,0,13,2,55,17,38,48.2,20.4,27.8,0,0,0,0
126,2fa2a875,37,3330,37,37,37,0,0,1,53,42,11,49.6,41.0,8.5,0,0,0,0
127,2fe83ffb,0,0,0,0,0,0,8,0,0,0,0,0.0,0.0,0.0,0,0,0,0
128,3010aefb,33,1840,20,21,8,12,1,0,17,41,-24,22.3,25.0,-2.7,0,0,0,0
129,30395d3b,25,1666,18,18,12,7,0,0,11,28,-17,18.6,23.9,-5.3,0,0,0,0
130,3067cbef,12,782,8,8,8,4,20,1,16,10,6,11.9,10.9,1.0,0,0,0,0
131,3071a619,26,1536,17,17,9,9,1,0,16,24,-8,21.2,20.2,1.0,0,0,0,0
132,31a62dc7,34,2971,33,34,29,0,1,2,60,26,34,51.7,35.8,15.9,0,0,0,0
133,3225654e,0,0,0,0,0,0,3,0,0,0,0,0.0,0.0,0.0,0,0,0,0
134,32c2d95f,38,3420,38,38,38,0,0,1,39,42,-3,38.1,45.0,-6.9,0,0,0,0
135,33508c78,13,966,10,12,8,1,0,1,13,16,-3,13.6,13.4,0.2,0,0,0,0
136,33887998,38,3420,38,38,38,0,0,1,39,42,-3,38.1,45.0,-6.9,0,0,0,0
137,34e38ddf,0,0,0,0,0,0,19,0,0,0,0,0.0,0.0,0.0,0,0,0,0
138,3681cfff,33,2937,32,33,32,0,1,1,27,26,1,38.4,40.8,-2.4,0,0,0,0
139,3708e9fa,30,2290,25,27,14,3,0,0,26,36,-10,29.9,31.2,-1.2,0,0,0,0
140,375622c5,28,1990,22,22,15,6,7,4,38,32,6,32.2,31.8,0.4,0,0,0,0
141,3767b3b7,16,1015,11,10,8,6,10,3,18,15,3,14.4,15.1,-0.7,0,0,0,0
142,378825c7,25,2152,23,24,21,1,1,1,33,33,0,34.6,28.3,6.2,0,0,0,0
143,380a15e2,1,90,1,1,1,0,30,1,0,0,0,0.5,0.8,-0.3,0,0,0,0
144,3814120d,0,0,0,0,0,0,31,0,0,0,0,0.0,0.0,0.0,0,0,0,0
145,392d98fc,8,74,0,0,0,8,5,1,0,3,-3,1.3,1.0,0.4,0,0,0,0
146,397ba086,1,2,0,0,0,1,1,3,0,0,0,0.0,0.0,0.0,0,0,0,0
147,39901146,10,434,4,3,0,7,0,0,5,10,-5,6.1,6.6,-0.5,0,0,0,0
148,3acddfdd,8,134,1,0,0,8,1,0,2,3,-1,2.7,2.6,0.1,0,0,0,0
149,3befc2b6,20,1475,16,18,12,2,2,1,25,16,9,22.6,17.1,5.5,0,0,0,0
150,3cefcaef,30,2531,28,27,26,3,1,1,52,34,18,51.5,33.4,18.1,0,0,0,0
151,3d3b0206,11,239,2,2,0,9,8,0,6,5,1,3.4,4.0,-0.6,0,0,0,0
152,3dd738a1,29,2528,28,29,26,0,0,1,39,30,9,37.7,31.8,5.8,0,0,0,0
153,3e092724,29,2360,26,27,22,2,1,1,20,22,-2,30.1,32.4,-2.3,0,0,0,0
154,3e87d087,16,1119,12,12,8,4,4,0,9,17,-8,8.5,23.4,-15.0,0,0,0,0
155,3eaf8817,35,2024,22,21,9,14,2,3,40,27,13,28.4,30.5,-2.1,0,0,0,0
156,3ef0fa48,16,1389,15,16,12,0,0,1,18,19,-1,21.8,19.3,2.5,0,0,0,0
157,3f5b4635,37,3292,36,37,36,0,0,1,51,41,10,48.8,39.9,8.9,0,0,0,0
158,403f5d20,14,863,9,10,7,4,14,1,4,12,-8,9.2,12.5,-3.3,0,0,0,0
159,41e7ef1c,19,1010,11,11,3,8,3,2,32,13,19,27.7,9.5,18.2,0,0,0,0
160,4207e578,30,1973,21,23,12,7,0,1,20,25,-5,20.0,27.0,-6.9,0,0,0,0
161,42c8ede1,4,56,0,0,0,4,2,0,2,1,1,1.6,0.1,1.5,0,0,0,0
162,42e8eba2,3,107,1,1,0,2,12,1,0,3,-3,0.4,3.0,-2.6,0,0,0,0
163,42eaa028,38,2796,31,34,12,4,0,1,49,25,24,46.0,32.8,13.3,0,0,0,0
164,42fd9c7f,29,2343,26,24,22,5,0,2,81,21,60,67.2,23.5,43.7,0,0,0,0
165,4315f30d,35,2994,33,34,32,1,2,1,27,29,-2,40.2,45.2,-5.0,0,0,0,0
166,433dc9a2,25,1836,20,21,15,4,0,2,55,15,40,46.7,20.6,26.1,0,0,0,0
167,43af5b1b,1,5,0,0,0,1,0,0,0,0,0,0.3,0.2,0.1,0,0,0,0
168,43e7a164,31,2754,30,31,30,0,1,0,19,40,-21,27.2,47.2,-19.9,0,0,0,0
169,44f8c299,18,1188,13,17,6,1,5,1,9,17,-8,13.0,17.0,-4.0,0,0,0,0
170,450e277f,30,2490,27,28,26,2,3,1,28,34,-6,33.1,35.7,-2.6,0,0,0,0
171,462475ed,25,1531,17,18,6,7,3,1,22,25,-3,17.6,23.3,-5.7,0,0,0,0
172,46291841,16,984,10,10,6,6,17,0,10,16,-6,13.8,17.3,-3.5,0,0,0,0
173,468fdbad,23,2059,22,23,21,0,1,1,36,28,8,24.6,26.6,-2.1,0,0,0,0
174,46907171,33,2246,25,25,8,8,0,1,32,31,1,29.6,30.3,-0.7,0,0,0,0
175,469d3d84,3,32,0,0,0,3,4,1,0,0,0,1.0,1.3,-0.3,0,0,0,0
176,46d50339,14,885,9,11,7,3,9,2,9,7,2,10.5,13.8,-3.2,0,0,0,0
177,4749367a,4,292,3,4,1,0,14,1,2,4,-2,3.5,4.1,-0.6,0,0,0,0
178,475583ff,20,1329,14,14,13,6,18,1,19,29,-10,20.4,23.8,-3.4,0,0,0,0
179,47af88b8,31,2754,30,31,29,0,2,1,55,43,12,60.7,36.7,24.0,0,0,0,0
180,4887118d,7,276,3,3,0,4,3,0,2,3,-1,2.9,3.2,-0.2,0,0,0,0
181,48b28bfd,17,1075,11,12,7,5,5,1,10,13,-3,15.6,13.9,1.7,0,0,0,0
182,49000148,9,721,8,9,4,0,1,0,7,12,-5,8.8,13.0,-4.1,0,0,0,0
183,49070d66,0,0,0,0,0,0,1,0,0,0,0,0.0,0.0,0.0,0,0,0,0
184,4914ed4a,19,1429,15,16,10,3,0,1,17,17,0,21.1,19.9,1.3,0,0,0,0
185,4a57580c,23,1482,16,16,9,7,2,1,22,21,1,23.9,22.1,1.8,0,0,0,0
186,4b96c347,31,1635,18,18,4,13,2,1,25,29,-4,26.1,21.5,4.6,0,0,0,0
187,4be0b467,30,1591,17,19,2,11,1,1,25,17,8,28.3,21.4,6.9,0,0,0,0
188,4bf69118,30,2040,22,22,18,8,4,1,26,28,-2,27.5,27.2,0.2,0,0,0,0
189,4c5b714f,26,2076,23,22,22,4,0,0,21,36,-15,30.4,31.0,-0.6,0,0,0,0
190,4c700f46,22,1278,14,12,11,10,8,1,18,25,-7,21.1,17.8,3.3,0,0,0,0
191,4d1666ff,37,3330,37,37,37,0,0,1,34,41,-7,39.2,52.6,-13.5,0,0,0,0
192,4d3e9033,4,360,4,4,4,0,33,2,8,5,3,6.5,3.2,3.4,0,0,0,0
193,4db2157a,20,1669,18,19,13,1,0,1,28,22,6,26.4,22.5,4.0,0,0,0,0
194,4e7bfc23,20,1076,12,15,4,5,8,0,9,25,-16,10.4,21.6,-11.2,0,0,0,0
195,4e9957ff,0,0,0,0,0,0,1,0,0,0,0,0.0,0.0,0.0,0,0,0,0
196,4f255115,10,704,7,8,4,2,7,1,6,6,0,8.3,9.4,-1.0,0,0,0,0
197,4fdf1fd9,33,2970,33,33,33,0,0,1,33,36,-3,34.0,38.4,-4.4,0,0,0,0
198,5046b7d4,32,2469,27,31,6,1,0,1,31,28,3,33.7,33.4,0.3,0,0,0,0
199,5113d9a7,9,717,8,7,7,2,3,0,5,19,-14,8.0,15.4,-7.4,0,0,0,0
200,51450467,1,15,0,0,0,1,7,1,2,0,2,0.9,0.1,0.8,0,0,0,0
201,5148dcc5,32,1486,16,16,5,16,4,2,36,21,15,35.9,20.6,15.4,0,0,0,0
202,516dc25b,23,1443,16,16,11,7,9,0,10,20,-10,17.4,20.7,-3.4,0,0,0,0
203,51c30111,13,1053,11,12,11,1,1,0,13,20,-7,10.0,20.9,-10.9,0,0,0,0
204,51dbeea9,27,1902,21,19,17,8,4,2,64,23,41,52.2,23.7,28.5,0,0,0,0
205,527f063d,21,1671,18,20,14,1,2,2,57,15,42,45.0,20.1,24.9,0,0,0,0
206,5314e067,25,1895,21,23,14,2,3,1,28,36,-8,23.8,37.3,-13.6,0,0,0,0
207,53283127,5,168,1,2,0,3,7,1,1,4,-3,0.9,1.8,-0.9,0,0,0,0
208,542cc80f,35,1789,19,18,13,17,1,1,28,22,6,23.1,24.6,-1.5,0,0,0,0
209,562ece0c,0,0,0,0,0,0,9,0,0,0,0,0.0,0.0,0.0,0,0,0,0
210,56f7a928,20,1680,18,20,15,0,0,0,18,30,-12,20.5,23.6,-3.1,0,0,0,0
211,574aa9ec,3,136,1,1,1,2,4,2,1,1,0,1.9,2.1,-0.2,0,0,0,0
212,57c433c8,2,144,1,2,0,0,1,1,2,2,0,0.7,1.5,-0.8,0,0,0,0
213,57e3f0c7,38,3324,36,37,28,1,0,1,66,28,38,57.8,39.0,18.9,0,0,0,0
214,586ef3a3,0,0,0,0,0,0,13,0,0,0,0,0.0,0.0,0.0,0,0,0,0
215,58ae47b2,31,1904,21,23,8,8,3,1,33,31,2,31.7,25.8,5.9,0,0,0,0
216,5b54bf3b,16,691,7,9,2,7,11,0,6,10,-4,7.2,10.2,-3.1,0,0,0,0
217,5b5724d2,23,1727,19,20,15,3,1,1,32,25,7,20.2,27.7,-7.6,0,0,0,0
218,5c2da10f,26,1204,13,14,2,12,3,2,33,14,19,23.6,17.1,6.6,0,0,0,0
219,5c4dc0ff,3,143,1,2,0,1,0,2,2,1,1,2.0,0.8,1.2,0,0,0,0
220,5cdddffa,34,2690,29,31,26,3,3,1,56,35,21,58.2,34.3,23.8,0,0,0,0
221,5d42d487,5,209,2,3,0,2,4,0,1,5,-4,1.6,2.4,-0.8,0,0,0,0
222,5d59e0df,19,1369,15,16,6,3,0,1,24,22,2,18.3,19.2,-0.9,0,0,0,0
223,5d8d7454,34,2916,32,33,31,1,0,0,27,45,-18,28.0,53.6,-25.6,0,0,0,0
224,5d9577aa,0,0,0,0,0,0,4,0,0,0,0,0.0,0.0,0.0,0,0,0,0
225,5e22e2a4,38,3245,36,37,33,1,0,1,38,48,-10,46.2,45.3,0.9,0,0,0,0
226,5ee6e943,21,1890,21,21,21,0,13,0,16,34,-18,22.2,31.5,-9.3,0,0,0,0
227,5f4ce4b6,14,720,8,9,2,5,13,0,8,12,-4,8.2,14.0,-5.8,0,0,0,0
228,6043997c,8,539,6,6,5,2,7,0,9,12,-3,7.9,10.3,-2.5,0,0,0,0
229,60d90c55,38,3420,38,38,38,0,0,0,29,54,-25,31.0,63.8,-32.8,0,0,0,0
230,61590953,12,698,7,8,5,4,15,2,18,9,9,14.9,6.4,8.5,0,0,0,0
231,6191093d,34,2372,26,27,15,7,2,0,20,42,-22,26.6,35.2,-8.6,0,0,0,0
232,62a54183,1,1,0,0,0,1,8,0,0,0,0,0.0,0.0,0.0,0,0,0,0
233,63a10528,6,204,2,2,1,4,2,1,3,5,-2,1.9,4.4,-2.5,0,0,0,0
234,6421dd73,35,2469,27,30,11,5,0,1,23,42,-19,29.5,38.4,-8.9,0,0,0,0
235,6453830e,1,1,0,0,0,1,3,3,0,0,0,0.0,0.0,0.0,0,0,0,0
236,6481421d,28,1600,17,18,7,10,2,1,20,19,1,18.5,19.8,-1.3,0,0,0,0
237,64ba07c0,4,355,3,4,3,0,3,2,7,2,5,5.9,3.7,2.2,0,0,0,0
238,65391fa7,2,92,1,1,1,1,2,3,2,1,1,1.0,1.6,-0.5,0,0,0,0
239,66116290,33,2557,28,29,18,4,0,0,29,45,-16,36.2,37.1,-0.9,0,0,0,0
240,6644712a,1,12,0,0,0,1,3,3,0,0,0,0.2,0.0,0.2,0,0,0,0
241,6690ef25,31,2667,29,31,29,0,0,1,41,24,17,40.0,25.9,14.2,0,0,0,0
242,677ee102,23,1431,15,15,10,8,9,1,12,28,-16,17.6,25.7,-8.1,0,0,0,0
243,67ac5bb8,14,1066,11,11,11,3,7,2,22,5,17,19.0,10.3,8.7,0,0,0,0
244,67b7357e,9,411,4,6,4,3,9,0,2,6,-4,4.5,6.5,-2.0,0,0,0,0
245,67cd5f5d,0,0,0,0,0,0,5,0,0,0,0,0.0,0.0,0.0,0,0,0,0
246,68a87d66,13,442,4,4,1,9,6,1,6,2,4,8.4,5.4,3.0,0,0,0,0
247,69384e5d,17,1439,16,16,11,1,0,2,50,14,36,37.3,17.6,19.7,0,0,0,0
248,698b37b8,1,19,0,0,0,1,1,0,0,0,0,0.8,0.0,0.7,0,0,0,0
249,698f11e3,0,0,0,0,0,0,1,0,0,0,0,0.0,0.0,0.0,0,0,0,0
250,6a189491,7,593,6,7,4,0,2,0,9,9,0,10.7,8.0,2.7,0,0,0,0
251,6a827d8e,29,2263,25,25,23,4,0,1,21,21,0,33.1,31.2,1.9,0,0,0,0
252,6b200d45,31,2700,30,31,29,0,1,1,44,33,11,43.3,41.7,1.6,0,0,0,0
253,6b2c894b,20,1800,20,20,20,0,0,1,16,19,-3,18.3,21.9,-3.6,0,0,0,0
254,6b9f2f3e,6,449,5,3,3,3,13,0,4,8,-4,4.0,6.4,-2.4,0,0,0,0
255,6bca20fe,12,850,9,10,6,2,9,0,11,16,-5,13.2,15.0,-1.8,0,0,0,0
256,6bde367b,32,2864,31,32,30,0,0,1,51,48,3,42.8,45.8,-3.0,0,0,0,0
257,6be41a31,0,0,0,0,0,0,3,0,0,0,0,0.0,0.0,0.0,0,0,0,0
258,6c6ecdd4,7,455,5,6,1,1,0,1,4,9,-5,4.6,9.5,-4.9,0,0,0,0
259,6c8ddd52,1,14,0,0,0,1,4,1,0,0,0,0.5,0.2,0.3,0,0,0,0
260,6c9642ae,8,357,4,4,2,4,13,1,1,6,-5,3.0,5.7,-2.7,0,0,0,0
261,6ca88b2a,22,1935,21,21,21,1,7,0,19,32,-13,24.9,32.0,-7.1,0,0,0,0
262,6dfd8f05,0,0,0,0,0,0,1,0,0,0,0,0.0,0.0,0.0,0,0,0,0
263,6e2c94ad,25,1235,13,14,2,11,11,0,21,23,-2,19.7,20.1,-0.4,0,0,0,0
264,6e51bf28,0,0,0,0,0,0,2,0,0,0,0,0.0,0.0,0.0,0,0,0,0
265,6e5b5a45,34,3024,33,34,31,0,1,0,26,51,-25,35.7,51.4,-15.7,0,0,0,0
266,6e7f1353,33,2403,26,27,17,6,2,1,49,34,15,36.7,28.8,7.9,0,0,0,0
267,6ed1a2a2,31,1843,20,21,7,10,6,1,18,30,-12,26.5,26.3,0.3,0,0,0,0
268,6f6d9eac,0,0,0,0,0,0,5,0,0,0,0,0.0,0.0,0.0,0,0,0,0
269,6f8cd6d0,32,2571,28,32,20,0,0,0,22,56,-34,31.8,40.1,-8.2,0,0,0,0
270,6fb7edd3,1,14,0,0,0,1,1,0,0,1,-1,0.0,1.1,-1.1,0,0,0,0
271,6fbde63a,2,160,1,2,0,0,0,2,3,1,2,2.1,1.7,0.4,0,0,0,0
272,6fea4e00,1,90,1,1,1,0,0,3,2,1,1,0.7,2.3,-1.6,0,0,0,0
273,6ff8ef56,18,627,7,5,0,13,6,1,12,7,5,10.8,7.2,3.5,0,0,0,0
274,706a60e1,14,952,10,10,2,4,1,1,8,11,-3,11.8,12.5,-0.8,0,0,0,0
275,7091324a,0,0,0,0,0,0,2,0,0,0,0,0.0,0.0,0.0,0,0,0,0
276,71ec39ef,30,1727,19,20,11,10,5,1,35,22,13,34.1,18.5,15.6,0,0,0,0
277,743fdcd3,8,469,5,4,2,4,6,0,3,12,-9,6.4,8.5,-2.1,0,0,0,0
278,745ca0a3,1,90,1,1,1,0,1,0,0,2,-2,0.6,1.1,-0.4,0,0,0,0
279,74dc806c,26,2033,22,23,16,3,2,1,30,30,0,32.2,26.4,5.7,0,0,0,0
280,75926036,0,0,0,0,0,0,5,0,0,0,0,0.0,0.0,0.0,0,0,0,0
281,76806215,9,682,7,7,7,2,29,1,18,12,6,11.7,10.1,1.6,0,0,0,0
282,769fc991,0,0,0,0,0,0,1,0,0,0,0,0.0,0.0,0.0,0,0,0,0
283,76c131da,3,23,0,0,0,3,2,2,0,0,0,0.1,0.3,-0.3,0,0,0,0
284,770d7eb8,34,3060,34,34,34,0,0,1,56,42,14,39.1,44.8,-5.7,0,0,0,0
285,775185ae,20,627,7,6,0,14,6,1,10,4,6,8.4,8.7,-0.3,0,0,0,0
286,7768df30,33,2647,29,29,28,4,5,0,21,50,-29,33.6,40.5,-6.9,0,0,0,0
287,779847d6,24,2160,24,24,24,0,6,1,31,28,3,31.7,27.1,4.5,0,0,0,0
288,77cf6852,35,2974,33,33,32,2,2,1,28,43,-15,31.7,43.9,-12.2,0,0,0,0
289,77d7c96f,13,1048,11,12,9,1,11,1,22,18,4,24.0,10.0,14.0,0,0,0,0
290,77f278a0,17,364,4,3,0,14,11,1,9,6,3,7.1,4.5,2.7,0,0,0,0
291,7800bdb8,0,0,0,0,0,0,29,0,0,0,0,0.0,0.0,0.0,0,0,0,0
292,78853b7b,0,0,0,0,0,0,3,0,0,0,0,0.0,0.0,0.0,0,0,0,0
293,79135368,36,3240,36,36,36,0,0,0,28,54,-26,29.7,60.8,-31.1,0,0,0,0
294,79584585,3,159,1,2,0,1,6,3,6,0,6,3.5,1.5,2.0,0,0,0,0
295,7961f7aa,19,938,10,10,4,9,2,0,6,19,-13,9.0,19.1,-10.1,0,0,0,0
296,796b1c41,25,1353,15,17,1,8,8,0,13,26,-13,10.1,26.8,-16.6,0,0,0,0
297,797f6070,2,116,1,2,0,0,2,0,0,2,-2,1.8,1.8,0.0,0,0,0,0
298,79b2399c,26,1842,20,21,14,5,4,1,27,29,-2,31.4,27.0,4.4,0,0,0,0
299,7a0b1e96,0,0,0,0,0,0,2,0,0,0,0,0.0,0.0,0.0,0,0,0,0
300,7a137df4,1,5,0,0,0,1,6,3,1,0,1,0.5,0.0,0.5,0,0,0,0
301,7add56e1,1,90,1,1,1,0,2,0,1,2,-1,1.3,2.0,-0.7,0,0,0,0
302,7b075c75,20,1723,19,20,17,0,2,2,35,19,16,30.3,21.9,8.4,0,0,0,0
303,7b92c092,0,0,0,0,0,0,37,0,0,0,0,0.0,0.0,0.0,0,0,0,0
304,7b9a86e6,15,468,5,3,1,12,7,0,4,6,-2,4.7,7.4,-2.7,0,0,0,0
305,7b9a9e25,25,1050,11,11,1,14,11,1,23,11,12,20.2,16.5,3.7,0,0,0,0
306,7b9c2d84,7,364,4,4,1,3,7,1,8,5,3,8.1,7.1,1.0,0,0,0,0
307,7c2965bb,24,1849,20,22,12,2,0,1,24,31,-7,26.4,28.9,-2.5,0,0,0,0
308,7c56da38,22,1156,12,13,7,9,14,2,35,9,26,33.8,11.3,22.5,0,0,0,0
309,7c6d6c96,30,2620,29,30,28,0,0,1,25,44,-19,29.1,40.4,-11.2,0,0,0,0
310,7cab69b5,25,2224,24,25,23,0,6,0,26,37,-11,28.8,35.7,-6.9,0,0,0,0
311,7cdda3bf,37,2985,33,36,16,1,0,1,45,32,13,41.3,33.4,7.899999999999999,0,0,0,0
312,7cf431a5,24,1220,13,14,5,10,4,1,14,17,-3,19.3,16.6,2.8,0,0,0,0
313,7d937aa1,30,2153,23,24,17,6,8,1,36,34,2,31.9,36.3,-4.4,0,0,0,0
314,7d9397f8,0,0,0,0,0,0,5,0,0,0,0,0.0,0.0,0.0,0,0,0,0
315,7d9b37bf,19,629,7,6,1,13,8,1,9,13,-4,9.8,14.7,-4.9,0,0,0,0
316,7e82a78f,32,2564,28,31,12,1,0,1,41,32,9,35.8,30.6,5.2,0,0,0,0
317,7f622eef,7,217,2,2,1,5,12,1,3,4,-1,5.0,4.3,0.7,0,0,0,0
318,7fb301af,3,119,1,1,1,2,3,1,1,2,-1,1.1,1.8,-0.7,0,0,0,0
319,7fecbcdb,30,2573,28,29,27,1,4,1,36,33,3,37.7,36.8,0.9,0,0,0,0
320,7ffaf233,22,793,8,7,0,15,7,1,10,7,3,10.6,7.3,3.3,0,0,0,0
321,80556f08,23,1333,14,16,6,7,8,0,11,18,-7,14.5,23.6,-9.1,0,0,0,0
322,80d1adb3,0,0,0,0,0,0,2,0,0,0,0,0.0,0.0,0.0,0,0,0,0
323,813aae2f,15,566,6,4,1,11,8,0,6,16,-10,8.4,10.6,-2.2,0,0,0,0
324,81d3318f,37,2561,28,29,12,8,0,1,26,32,-6,28.8,37.5,-8.7,0,0,0,0
325,821233cc,26,2149,23,26,22,0,0,1,37,32,5,38.2,30.7,7.5,0,0,0,0
326,822d51d7,17,912,10,10,7,7,10,1,19,14,5,12.7,18.0,-5.4,0,0,0,0
327,82671804,30,2436,27,26,25,4,3,1,43,43,0,38.9,35.3,3.6,0,0,0,0
328,8325870c,6,506,5,6,5,0,7,1,8,5,3,7.3,7.4,-0.2,0,0,0,0
329,834b5c4c,37,3330,37,37,37,0,1,1,57,48,9,40.4,49.5,-9.1,0,0,0,0
330,8417953b,3,226,2,2,2,1,12,0,4,7,-3,4.2,3.3,0.9,0,0,0,0
331,84549a07,22,817,9,8,1,14,8,0,5,9,-4,13.9,9.5,4.4,0,0,0,0
332,84d94b91,33,2818,31,32,28,1,1,1,23,42,-19,28.9,40.4,-11.5,0,0,0,0
333,854a2041,2,29,0,0,0,2,13,1,1,0,1,0.2,0.2,-0.1,0,0,0,0
334,8577e60a,1,10,0,0,0,1,4,3,0,0,0,0.0,0.0,0.0,0,0,0,0
335,8608f269,0,0,0,0,0,0,1,0,0,0,0,0.0,0.0,0.0,0,0,0,0
336,86574238,1,68,0,1,0,0,0,0,1,2,-1,0.4,0.9,-0.6,0,0,0,0
337,86df8ac0,1,1,0,0,0,1,7,1,0,0,0,0.0,0.0,0.0,0,0,0,0
338,86e7deaf,25,2077,23,24,21,1,2,2,69,15,54,56.9,19.5,37.4,0,0,0,0
339,872cd68c,1,4,0,0,0,1,2,0,0,1,-1,0.0,0.4,-0.4,0,0,0,0
340,873ce3a2,12,454,5,5,0,7,24,1,10,6,4,10.2,4.9,5.3,0,0,0,0
341,8746d5d0,17,1352,15,15,11,2,12,1,10,16,-6,16.7,21.9,-5.2,0,0,0,0
342,8794e251,14,1063,11,12,10,2,0,2,38,8,30,29.1,11.7,17.5,0,0,0,0
343,8802c1d5,14,538,6,6,0,8,7,1,6,4,2,7.1,8.1,-1.0,0,0,0,0
344,885b7aa7,11,744,8,8,3,3,5,0,6,14,-8,7.2,11.7,-4.5,0,0,0,0
345,8870154f,13,1170,13,13,13,0,25,0,7,17,-10,10.6,20.3,-9.7,0,0,0,0
346,88f130ed,10,834,9,10,8,0,1,1,10,14,-4,10.6,13.2,-2.6,0,0,0,0
347,8a2248b4,35,3150,35,35,35,0,3,1,29,29,0,42.4,46.7,-4.3,0,0,0,0
348,8b28686a,18,1620,18,18,18,0,0,0,15,26,-11,23.0,25.8,-2.8,0,0,0,0
349,8b298f56,33,2668,29,29,25,4,2,1,48,36,12,44.0,36.7,7.4,0,0,0,0
350,8b529245,16,523,5,3,2,13,0,1,8,5,3,9.9,7.6,2.4,0,0,0,0
351,8b66d9cc,22,1224,13,13,5,9,5,1,13,14,-1,17.4,18.7,-1.3,0,0,0,0
352,8c2c48a9,1,13,0,0,0,1,3,0,0,0,0,0.1,0.0,0.1,0,0,0,0
353,8c955557,17,456,5,2,1,15,7,0,7,8,-1,8.3,9.4,-1.1,0,0,0,0
354,8ca253a3,25,1499,16,16,8,9,3,0,13,23,-10,15.0,27.3,-12.3,0,0,0,0
355,8da74c05,37,2942,32,34,23,3,0,1,25,33,-8,37.9,45.8,-7.9,0,0,0,0
356,8dbff17c,16,1412,15,16,14,0,8,1,26,22,4,22.7,19.9,2.8,0,0,0,0
357,8eec784d,2,54,0,1,0,1,0,3,1,1,0,1.2,1.1,0.1,0,0,0,0
358,8f325097,12,984,10,11,8,1,17,1,17,17,0,14.4,16.3,-1.8,0,0,0,0
359,8f4d116f,36,2805,31,31,19,5,0,1,43,33,10,43.0,31.7,11.2,0,0,0,0
360,8f534f8e,2,180,2,2,2,0,3,3,6,1,5,4.4,3.2,1.2,0,0,0,0
361,8f696594,36,2737,30,29,22,7,2,1,54,34,20,58.0,35.1,22.9,0,0,0,0
362,8fa8f8d2,25,2250,25,25,25,0,12,1,24,43,-19,29.2,37.9,-8.7,0,0,0,0
363,8ff07990,25,1685,18,21,4,4,0,3,19,18,1,22.200000000000003,21.7,0.3999999999999999,0,0,0,0
364,8ff4872e,20,1707,19,19,18,1,5,0,16,44,-28,22.2,29.7,-7.5,0,0,0,0
365,9001138b,23,1175,13,12,5,11,12,1,26,13,13,20.7,16.7,4.1,0,0,0,0
366,909222de,34,2052,22,22,9,12,3,1,37,31,6,26.2,33.0,-6.8,0,0,0,0
367,90eb507d,32,2880,32,32,32,0,0,1,32,32,0,33.6,35.0,-1.3,0,0,0,0
368,90f87966,36,3110,34,36,34,0,0,2,60,28,32,55.4,38.4,17.0,0,0,0,0
369,90fcf472,34,2253,25,25,9,9,3,0,18,44,-26,23.1,40.0,-16.9,0,0,0,0
370,91e58f66,24,1021,11,10,5,14,9,1,15,19,-4,18.3,16.1,2.2,0,0,0,0
371,91f2da4c,33,2468,27,28,16,5,2,0,20,36,-16,22.0,46.2,-24.2,0,0,0,0
372,92232aad,24,1941,21,23,15,1,2,1,29,22,7,30.0,27.3,2.7,0,0,0,0
373,923f4dda,13,1111,12,13,9,0,0,1,11,11,0,13.7,10.7,2.9,0,0,0,0
374,92b1763b,5,50,0,0,0,5,9,1,3,2,1,0.8,2.4,-1.6,0,0,0,0
375,92b56413,20,1344,14,17,3,3,4,1,18,16,2,15.1,17.8,-2.7,0,0,0,0
376,92cd4bef,3,80,0,1,0,2,0,1,1,2,-1,1.1,1.2,-0.2,0,0,0,0
377,933d3b51,1,90,1,1,1,0,0,0,1,3,-2,1.4,2.6,-1.2,0,0,0,0
378,934a0957,2,22,0,0,0,2,3,1,0,0,0,0.2,0.5,-0.2,0,0,0,0
379,93c942fb,1,1,0,0,0,1,0,3,0,0,0,0.0,0.0,0.0,0,0,0,0
380,9453d2f4,24,1183,13,15,2,9,9,1,13,19,-6,13.7,18.4,-4.7,0,0,0,0
381,94f8d10c,20,1547,17,17,15,3,14,1,23,22,1,22.8,20.0,2.8,0,0,0,0
382,950ff24d,3,270,3,3,3,0,6,0,1,6,-5,3.9,3.3,0.6,0,0,0,0
383,95bb6ddc,0,0,0,0,0,0,1,0,0,0,0,0.0,0.0,0.0,0,0,0,0
384,972aeb2a,16,1277,14,13,11,3,14,2,28,11,17,20.5,18.7,1.7,0,0,0,0
385,97b87472,2,69,0,0,0,2,7,3,1,0,1,1.2,1.3,-0.1,0,0,0,0
386,97fb4608,6,495,5,6,5,0,7,1,6,8,-2,8.7,5.9,2.8,0,0,0,0
387,9836e892,1,8,0,0,0,1,1,1,0,0,0,0.0,0.1,0.0,0,0,0,0
388,9980269a,32,1751,19,19,13,13,4,1,24,22,2,27.0,22.4,4.5,0,0,0,0
389,9a1f2e1c,18,1023,11,11,9,7,2,1,19,13,6,21.4,14.0,7.3,0,0,0,0
390,9a506145,16,1057,11,12,7,4,10,1,9,14,-5,13.4,13.7,-0.2,0,0,0,0
391,9ae9eaea,12,878,9,12,7,0,10,1,16,9,7,14.7,10.2,4.5,0,0,0,0
392,9b398aea,3,57,0,0,0,3,16,0,1,3,-2,0.9,2.0,-1.1,0,0,0,0
393,9b6d9b53,18,1460,16,16,16,2,0,0,16,28,-12,20.3,24.5,-4.2,0,0,0,0
394,9bb0b9f1,0,0,0,0,0,0,3,0,0,0,0,0.0,0.0,0.0,0,0,0,0
395,9daeac61,7,605,6,7,6,0,3,1,9,9,0,8.6,9.2,-0.6,0,0,0,0
396,9dafff2a,13,665,7,6,3,7,11,2,4,19,-15,7.6,10.6,-3.0,0,0,0,0
397,9dd5da03,29,1853,20,20,16,9,6,0,18,29,-11,17.7,35.5,-17.8,0,0,0,0
398,9e27e5de,31,2343,26,26,21,5,2,0,18,33,-15,21.3,44.3,-23.0,0,0,0,0
399,9f29c204,11,544,6,6,3,5,27,1,3,11,-8,4.5,8.8,-4.3,0,0,0,0
400,9f6325f9,1,90,1,1,1,0,1,0,0,2,-2,0.2,1.5,-1.3,0,0,0,0
401,9f90c06b,7,420,4,4,4,3,18,1,3,6,-3,3.8,5.7,-1.9,0,0,0,0
402,9fc0f253,8,720,8,8,8,0,5,0,7,13,-6,8.8,11.2,-2.4,0,0,0,0
403,a0434482,34,2243,24,24,14,10,2,0,20,36,-16,21.6,35.6,-14.0,0,0,0,0
404,a08b974a,34,2708,30,31,21,3,0,1,49,36,13,44.6,33.0,11.6,0,0,0,0
405,a0f9b535,36,2985,33,34,23,2,0,1,40,40,0,45.0,41.0,4.0,0,0,0,0
406,a1d04509,17,923,10,9,6,8,5,0,9,11,-2,10.0,14.2,-4.1,0,0,0,0
407,a3a88c8e,0,0,0,0,0,0,1,0,0,0,0,0.0,0.0,0.0,0,0,0,0
408,a44d3a3c,3,82,0,0,0,3,0,0,1,2,-1,1.1,1.3,-0.2,0,0,0,0
409,a4527d33,1,90,1,1,1,0,6,3,1,0,1,0.9,1.7,-0.8,0,0,0,0
410,a46472d0,27,2152,23,23,23,4,3,1,32,30,2,26.8,32.7,-5.9,0,0,0,0
411,a4b1028a,34,2972,33,33,31,1,2,1,51,46,5,49.1,39.7,9.4,0,0,0,0
412,a4c3f7af,26,2023,22,23,16,3,1,0,18,30,-12,22.2,31.3,-9.2,0,0,0,0
413,a56bd2ee,17,1530,17,17,17,0,19,0,12,34,-22,18.2,21.9,-3.6,0,0,0,0
414,a5876fca,0,0,0,0,0,0,3,0,0,0,0,0.0,0.0,0.0,0,0,0,0
415,a5db0bec,37,3061,34,35,26,2,1,1,62,45,17,65.3,41.5,23.9,0,0,0,0
416,a6138e4a,20,1269,14,15,7,5,11,1,10,17,-7,9.4,21.9,-12.6,0,0,0,0
417,a634b9d2,11,469,5,4,4,7,13,2,10,9,1,9.0,6.5,2.6,0,0,0,0
418,a671316d,1,42,0,0,0,1,3,0,0,2,-2,0.3,2.1,-1.8,0,0,0,0
419,a6b6fa6e,0,0,0,0,0,0,1,0,0,0,0,0.0,0.0,0.0,0,0,0,0
420,a7e4760c,3,204,2,3,1,0,7,0,0,2,-2,1.3,3.1,-1.8,0,0,0,0
421,a8797cf1,5,230,2,3,0,2,5,1,4,3,1,2.2,2.7,-0.5,0,0,0,0
422,a8b4a643,15,651,7,6,2,9,12,1,6,8,-2,6.8,12.9,-6.1,0,0,0,0
423,aa21406e,1,3,0,0,0,1,3,0,1,1,0,0.4,0.5,0.0,0,0,0,0
424,ab096c6f,36,3184,35,35,34,1,1,1,54,39,15,53.3,45.9,7.4,0,0,0,0
425,abc06eb3,0,0,0,0,0,0,5,0,0,0,0,0.0,0.0,0.0,0,0,0,0
426,abccacf7,0,0,0,0,0,0,1,0,0,0,0,0.0,0.0,0.0,0,0,0,0
427,acde3581,13,340,3,2,0,11,2,0,4,6,-2,4.4,6.6,-2.3,0,0,0,0
428,ad82197c,4,159,1,1,1,3,18,1,4,4,0,1.4,3.0,-1.7,0,0,0,0
429,ae59b359,18,564,6,5,5,13,15,2,19,7,12,13.9,9.1,4.8,0,0,0,0
430,ae6941ec,3,257,2,3,2,0,2,0,1,6,-5,1.9,4.0,-2.1,0,0,0,0
431,ae82fa48,5,209,2,3,0,2,2,0,2,6,-4,3.6,4.1,-0.6,0,0,0,0
432,aeed036d,1,2,0,0,0,1,2,3,0,0,0,0.0,0.1,-0.1,0,0,0,0
433,aeed5c06,25,1141,12,10,6,15,11,2,32,12,20,31.7,12.0,19.7,0,0,0,0
434,aef6e670,24,2005,22,23,21,1,4,2,55,25,30,46.5,25.4,21.0,0,0,0,0
435,af0c835b,28,1648,18,19,8,9,5,1,20,26,-6,21.6,22.7,-1.1,0,0,0,0
436,b0547a87,23,1271,14,14,8,9,9,1,13,13,0,14.7,19.9,-5.2,0,0,0,0
437,b056e3da,27,2390,26,27,26,0,1,1,29,30,-1,32.7,32.1,0.6,0,0,0,0
438,b095d5b8,0,0,0,0,0,0,6,0,0,0,0,0.0,0.0,0.0,0,0,0,0
439,b197f56e,0,0,0,0,0,0,3,0,0,0,0,0.0,0.0,0.0,0,0,0,0
440,b1adaefa,2,173,1,1,1,1,1,1,0,1,-1,1.3,1.9,-0.6,0,0,0,0
441,b2459674,3,15,0,0,0,3,1,0,0,1,-1,0.1,0.8,-0.8,0,0,0,0
442,b2bd0f6c,38,3004,33,35,25,3,0,1,62,29,33,53.0,37.9,15.0,0,0,0,0
443,b4a014b1,35,3148,35,35,34,0,1,1,46,44,2,45.2,42.5,2.7,0,0,0,0
444,b4c816a9,18,493,5,4,1,14,11,1,6,5,1,8.0,7.0,1.0,0,0,0,0
445,b6047994,0,0,0,0,0,0,3,0,0,0,0,0.0,0.0,0.0,0,0,0,0
446,b666421b,30,2636,29,29,28,1,2,1,34,38,-4,37.8,38.1,-0.3,0,0,0,0
447,b66d1d8a,13,1117,12,12,11,1,11,1,19,22,-3,17.7,17.7,0.0,0,0,0,0
448,b684a484,15,608,6,7,1,8,5,1,11,9,2,11.4,7.5,3.9,0,0,0,0
449,b6dac747,24,1928,21,23,18,1,8,0,14,36,-22,22.3,31.8,-9.5,0,0,0,0
450,b7e7937d,23,2058,22,22,22,1,11,0,20,38,-18,25.9,33.1,-7.2,0,0,0,0
451,b832756a,0,0,0,0,0,0,1,0,0,0,0,0.0,0.0,0.0,0,0,0,0
452,b8d22478,21,1281,14,14,9,7,0,1,13,14,-1,17.3,19.6,-2.3,0,0,0,0
453,b92edde2,30,2537,28,28,27,2,5,0,23,27,-4,30.9,36.7,-5.8,0,0,0,0
454,b931d9d1,11,739,8,8,5,3,10,0,5,12,-7,7.0,14.5,-7.5,0,0,0,0
455,b99bec05,24,1994,22,23,21,1,10,1,19,31,-12,27.3,33.3,-6.0,0,0,0,0
456,bb4a42be,22,901,10,9,1,13,6,1,18,17,1,17.7,16.3,1.4,0,0,0,0
457,bc0bfc64,7,198,2,3,0,4,4,0,2,2,0,2.2,4.3,-2.1,0,0,0,0
458,bc270726,38,3420,38,38,38,0,0,1,31,52,-21,35.4,49.8,-14.5,0,0,0,0
459,bc7b4580,20,1276,14,15,6,5,7,1,19,20,-1,19.5,20.2,-0.7,0,0,0,0
460,bcc81786,32,2880,32,32,32,0,1,1,31,47,-16,40.8,47.8,-7.1,0,0,0,0
461,bced0375,28,2467,27,27,27,1,0,1,27,41,-14,34.2,41.5,-7.3,0,0,0,0
462,bcf1b2e9,31,2704,30,31,30,0,2,0,25,45,-20,35.7,45.8,-10.1,0,0,0,0
463,bd4f5f94,6,494,5,6,5,0,4,0,4,9,-5,6.6,7.2,-0.5,0,0,0,0
464,bda82fc2,0,0,0,0,0,0,3,0,0,0,0,0.0,0.0,0.0,0,0,0,0
465,bdedd861,27,1252,13,11,9,16,4,1,23,21,2,19.7,20.0,-0.3,0,0,0,0
466,beae3a73,38,3006,33,34,28,4,0,1,52,54,-2,44.5,51.4,-6.9,0,0,0,0
467,beb391dd,27,1281,14,12,5,15,2,1,26,22,4,31.1,17.4,13.6,0,0,0,0
468,bece776f,29,1988,22,24,16,5,0,1,39,24,15,43.4,26.0,17.4,0,0,0,0
469,bfcef334,20,1508,16,16,16,4,11,0,11,25,-14,16.0,24.7,-8.7,0,0,0,0
470,bfdb33aa,35,2788,31,32,22,3,0,1,48,39,9,46.4,39.2,7.2,0,0,0,0
471,c05d65d1,0,0,0,0,0,0,1,0,0,0,0,0.0,0.0,0.0,0,0,0,0
472,c0b3669f,6,122,1,1,0,5,4,1,0,3,-3,1.4,0.6,0.8,0,0,0,0
473,c20bdcd7,3,97,1,1,1,2,6,0,1,3,-2,1.1,2.2,-1.1,0,0,0,0
474,c2211709,37,3090,34,35,31,2,0,1,48,36,12,45.2,36.1,9.2,0,0,0,0
475,c252c705,1,90,1,1,1,0,37,3,1,0,1,1.8,1.1,0.7,0,0,0,0
476,c26a3918,31,2790,31,31,31,0,1,1,35,39,-4,38.9,37.2,1.7,0,0,0,0
477,c27dfb82,18,1058,11,12,6,6,6,1,19,15,4,13.9,16.8,-2.9,0,0,0,0
478,c39d9657,5,446,5,5,4,0,2,1,4,10,-6,5.9,8.5,-2.6,0,0,0,0
479,c3e4ecbb,23,1802,20,21,18,2,12,1,19,27,-8,20.2,28.8,-8.7,0,0,0,0
480,c4527123,4,108,1,1,0,3,7,2,3,3,0,1.7,2.3,-0.6,0,0,0,0
481,c46fa34c,26,2009,22,23,17,3,5,2,29,27,2,27.3,31.0,-3.6,0,0,0,0
482,c47541e0,34,2117,23,24,9,10,3,1,40,32,8,44.8,26.7,18.1,0,0,0,0
483,c4bbea9f,36,3232,35,36,35,0,0,1,49,41,8,46.3,40.0,6.3,0,0,0,0
484,c58270f8,12,137,1,0,0,12,24,1,5,2,3,3.1,2.3,0.9,0,0,0,0
485,c5a500ca,36,3240,36,36,36,0,0,1,32,53,-21,44.3,53.4,-9.0,0,0,0,0
486,c6056d58,33,2970,33,33,33,0,0,0,33,48,-15,42.6,40.7,1.9,0,0,0,0
487,c64c01fc,0,0,0,0,0,0,1,0,0,0,0,0.0,0.0,0.0,0,0,0,0
488,c650629d,22,1476,16,17,8,5,2,1,19,21,-2,15.9,22.9,-7.0,0,0,0,0
489,c693347d,20,792,8,6,4,14,0,1,13,7,6,9.9,13.2,-3.3,0,0,0,0
490,c69a3268,0,0,0,0,0,0,8,0,0,0,0,0.0,0.0,0.0,0,0,0,0
491,c69ef855,27,1990,22,25,14,2,3,1,15,27,-12,20.3,29.3,-9.0,0,0,0,0
492,c6ac6579,14,580,6,7,1,7,6,1,12,11,1,9.7,8.8,0.9,0,0,0,0
493,c6e5d20f,35,3074,34,35,27,0,0,2,64,24,40,54.0,35.1,18.9,0,0,0,0
494,c76577a0,19,372,4,2,0,17,7,1,6,10,-4,6.0,5.8,0.2,0,0,0,0
495,c76b7567,34,2479,27,28,13,6,3,1,41,33,8,30.3,35.1,-4.8,0,0,0,0
496,c795c408,0,0,0,0,0,0,5,0,0,0,0,0.0,0.0,0.0,0,0,0,0
497,c801616a,29,1598,17,18,7,11,4,1,17,26,-9,25.6,20.9,4.7,0,0,0,0
498,c8090cb3,31,1770,19,20,9,11,7,1,24,32,-8,24.5,28.9,-4.4,0,0,0,0
499,c8c02ac7,20,1214,13,14,9,6,7,1,18,17,1,21.7,17.6,4.0,0,0,0,0
500,c8c60119,4,346,3,4,3,0,0,0,2,4,-2,4.4,4.4,0.0,0,0,0,0
501,c977ef13,1,90,1,1,1,0,11,0,0,1,-1,1.7,0.9,0.8,0,0,0,0
502,c9e99e49,23,1622,18,19,12,4,0,2,45,22,23,42.4,19.9,22.5,0,0,0,0
503,cac76a72,37,3330,37,37,37,0,1,1,58,40,18,55.1,48.3,6.8,0,0,0,0
504,cb9ec45d,1,90,1,1,1,0,0,0,0,4,-4,0.3,3.2,-2.9,0,0,0,0
505,cc77354e,31,2411,26,27,25,4,4,1,40,38,2,34.5,32.6,1.9,0,0,0,0
506,ccb1c3af,3,88,1,2,0,1,2,1,1,1,0,1.0,1.1,-0.1,0,0,0,0
507,ccee698e,29,1237,13,12,2,17,3,1,25,14,11,22.8,11.4,11.4,0,0,0,0
508,ce17b5eb,0,0,0,0,0,0,1,0,0,0,0,0.0,0.0,0.0,0,0,0,0
509,ce492295,29,2469,27,29,26,0,3,1,43,32,11,41.4,32.7,8.7,0,0,0,0
510,ce84946a,6,44,0,0,0,6,3,2,2,0,2,0.8,0.7,0.1,0,0,0,0
511,cfd41fad,1,8,0,0,0,1,0,3,0,0,0,0.0,0.1,-0.1,0,0,0,0
512,cfd8dde3,17,671,7,6,0,11,10,1,16,6,10,9.7,6.5,3.3,0,0,0,0
513,d00fe9a3,0,0,0,0,0,0,1,0,0,0,0,0.0,0.0,0.0,0,0,0,0
514,d14229f3,19,1240,13,14,8,5,5,1,24,20,4,22.3,17.5,4.9,0,0,0,0
515,d21e361a,18,328,3,0,0,18,8,1,7,4,3,8.9,5.2,3.8,0,0,0,0
516,d2448564,20,706,7,6,1,14,5,1,10,14,-4,10.7,14.3,-3.7,0,0,0,0
517,d29202c2,9,232,2,2,0,7,6,0,2,4,-2,3.0,4.1,-1.2,0,0,0,0
518,d2aa8ac0,31,2105,23,23,16,8,6,0,18,47,-29,24.7,33.7,-9.0,0,0,0,0
519,d33c706e,36,3115,34,36,19,0,0,1,49,35,14,46.2,35.0,11.2,0,0,0,0
520,d3b58e33,0,0,0,0,0,0,1,0,0,0,0,0.0,0.0,0.0,0,0,0,0
521,d3ce9f1f,2,126,1,1,1,1,0,1,3,3,0,1.2,2.2,-1.0,0,0,0,0
522,d4133fa1,37,3258,36,37,35,0,0,1,58,36,22,53.3,46.4,7.0,0,0,0,0
523,d504b3e1,35,2556,28,29,14,6,0,1,31,39,-8,37.7,39.3,-1.6,0,0,0,0
524,d512db65,5,204,2,2,0,3,1,1,3,5,-2,2.5,5.9,-3.4,0,0,0,0
525,d520120b,36,2805,31,31,27,5,0,0,24,48,-24,33.1,48.0,-15.0,0,0,0,0
526,d5f2f82b,30,2693,29,30,28,0,1,2,86,22,64,69.3,27.0,42.3,0,0,0,0
527,d63e2912,27,2374,26,26,26,1,2,1,46,32,14,39.7,29.9,9.8,0,0,0,0
528,d6f88a1d,15,1184,13,13,12,2,0,1,14,16,-2,17.9,17.6,0.3,0,0,0,0
529,d7553721,1,11,0,0,0,1,2,3,2,0,2,1.1,0.0,1.1,0,0,0,0
530,d7bf3d19,32,2522,28,30,21,2,2,0,20,46,-26,25.9,43.2,-17.3,0,0,0,0
531,d880dc16,3,177,2,2,1,1,7,2,1,2,-1,3.4,2.7,0.7,0,0,0,0
532,d8b97bb3,18,769,8,7,4,11,7,0,8,18,-10,10.2,12.3,-2.1,0,0,0,0
533,d8fc044e,1,25,0,0,0,1,7,3,0,0,0,1.2,0.2,1.0,0,0,0,0
534,d9a66c60,28,603,6,4,2,24,10,1,10,13,-3,11.4,9.8,1.6,0,0,0,0
535,d9f58d33,0,0,0,0,0,0,3,0,0,0,0,0.0,0.0,0.0,0,0,0,0
536,dab1b8dc,0,0,0,0,0,0,6,0,0,0,0,0.0,0.0,0.0,0,0,0,0
537,dc366c36,33,2925,32,32,32,1,5,1,47,48,-1,45.7,42.8,2.9,0,0,0,0
538,dc709ab5,17,1480,16,15,15,2,13,1,25,30,-5,21.6,22.2,-0.5,0,0,0,0
539,dcf7cf44,14,440,4,3,0,11,4,2,9,7,2,7.7,7.9,-0.2,0,0,0,0
540,dd73120f,3,37,0,0,0,3,2,2,0,0,0,0.5,0.3,0.2,0,0,0,0
541,de40e38c,1,90,1,1,1,0,5,0,0,2,-2,0.6,1.1,-0.4,0,0,0,0
542,de488e56,13,1163,12,13,12,0,11,1,12,10,2,15.7,14.4,1.3,0,0,0,0
543,df819670,12,408,4,4,3,8,7,4,4,6,-2,3.9,8.4,-4.5,0,0,0,0
544,dff153a4,16,1249,13,14,11,2,0,1,28,19,9,29.5,15.0,14.5,0,0,0,0
545,e0238966,0,0,0,0,0,0,6,0,0,0,0,0.0,0.0,0.0,0,0,0,0
546,e067808c,16,767,8,8,2,8,3,0,6,16,-10,9.3,15.4,-6.1,0,0,0,0
547,e0d725fe,0,0,0,0,0,0,5,0,0,0,0,0.0,0.0,0.0,0,0,0,0
548,e110ea4b,1,70,0,1,0,0,0,0,1,2,-1,0.4,0.9,-0.6,0,0,0,0
549,e162b013,22,1610,17,19,11,3,3,2,50,12,38,41.9,14.3,27.6,0,0,0,0
550,e1df6989,1,88,1,1,0,0,6,0,0,1,-1,1.6,0.9,0.7,0,0,0,0
551,e2f9bb5f,11,422,4,7,0,4,8,1,2,6,-4,3.4,6.4,-2.9,0,0,0,0
552,e39f8724,0,0,0,0,0,0,3,0,0,0,0,0.0,0.0,0.0,0,0,0,0
553,e3d0b0c4,33,2878,32,33,31,0,4,1,59,34,25,59.9,35.1,24.7,0,0,0,0
554,e3e05edf,26,2136,23,25,19,1,7,1,33,27,6,30.4,26.2,4.1,0,0,0,0
555,e4086af3,11,964,10,11,10,0,2,1,13,15,-2,11.5,15.1,-3.6,0,0,0,0
556,e40d028b,17,1530,17,17,17,0,20,2,50,18,32,40.7,17.2,23.4,0,0,0,0
557,e493cff8,2,25,0,0,0,2,2,0,1,0,1,1.0,0.3,0.7,0,0,0,0
558,e4a26a91,16,712,7,7,3,9,5,1,9,12,-3,11.4,12.4,-1.0,0,0,0,0
559,e50623a0,4,195,2,2,2,2,10,0,1,4,-3,3.8,2.7,1.1,0,0,0,0
560,e53ab10b,17,441,4,4,0,13,2,1,11,4,7,7.9,7.1,0.8,0,0,0,0
561,e54a9890,27,2137,23,25,22,2,5,1,38,29,9,32.2,33.1,-0.8,0,0,0,0
562,e562a02e,2,31,0,0,0,2,7,2,0,0,0,0.6,0.8,-0.2,0,0,0,0
563,e621fe01,0,0,0,0,0,0,2,0,0,0,0,0.0,0.0,0.0,0,0,0,0
564,e6777e6b,34,3026,33,34,32,0,0,1,50,45,5,35.3,46.1,-10.7,0,0,0,0
565,e68f2cb4,25,1877,20,22,13,3,1,1,15,28,-13,16.9,26.1,-9.2,0,0,0,0
566,e6951f76,0,0,0,0,0,0,34,0,0,0,0,0.0,0.0,0.0,0,0,0,0
567,e6eadfb8,20,1709,19,19,17,1,5,2,36,13,23,30.7,17.9,12.8,0,0,0,0
568,e750cba4,0,0,0,0,0,0,38,0,0,0,0,0.0,0.0,0.0,0,0,0,0
569,e7986081,33,2016,22,21,12,12,1,2,49,26,23,46.5,24.9,21.5,0,0,0,0
570,e8a65bc8,2,32,0,0,0,2,5,0,0,3,-3,0.7,1.0,-0.3,0,0,0,0
571,e8b5ad37,1,78,0,1,0,0,2,0,0,2,-2,0.3,1.5,-1.2,0,0,0,0
572,e8f9acf4,0,0,0,0,0,0,1,0,0,0,0,0.0,0.0,0.0,0,0,0,0
573,e90af77c,29,1319,14,14,1,15,4,1,19,23,-4,19.0,21.7,-2.7,0,0,0,0
574,e97150c0,12,1064,11,12,11,0,16,1,24,15,9,21.0,15.0,6.1,0,0,0,0
575,ea02beaf,37,2612,29,32,10,5,1,1,31,33,-2,27.9,34.2,-6.3,0,0,0,0
576,ea0aa7e0,10,326,3,3,1,7,4,1,6,3,3,5.6,4.2,1.4,0,0,0,0
577,ea0ff634,36,2170,24,23,13,13,2,1,41,32,9,31.9,28.6,3.3,0,0,0,0
578,ea540835,20,1259,14,18,5,2,5,1,11,18,-7,15.8,18.3,-2.5,0,0,0,0
579,eb68e86c,0,0,0,0,0,0,3,0,0,0,0,0.0,0.0,0.0,0,0,0,0
580,eb78322b,1,90,1,1,1,0,1,0,0,1,-1,1.7,0.9,0.8,0,0,0,0
581,eba1e557,3,61,0,0,0,3,3,1,1,0,1,1.1,0.2,0.8,0,0,0,0
582,ec400194,32,2674,29,30,24,2,2,0,24,42,-18,33.0,44.9,-11.8,0,0,0,0
583,ed0c3318,29,1473,16,16,8,13,7,0,19,23,-4,15.9,26.0,-10.1,0,0,0,0
584,ed45c4a5,36,3226,35,36,34,0,0,1,47,44,3,47.1,42.9,4.2,0,0,0,0
585,edd1466a,21,1847,20,21,14,0,13,0,15,25,-10,18.2,30.8,-12.6,0,0,0,0
586,ef2e5e1a,28,1942,21,21,17,7,3,1,31,34,-3,29.0,27.5,1.5,0,0,0,0
587,ef4b7c60,0,0,0,0,0,0,7,0,0,0,0,0.0,0.0,0.0,0,0,0,0
588,ef7cd87a,34,2749,30,30,27,4,3,1,42,37,5,41.5,40.0,1.4,0,0,0,0
589,ef9c1c95,30,2495,27,28,24,2,0,1,37,40,-3,38.5,34.2,4.3,0,0,0,0
590,f00de885,34,3060,34,34,34,0,0,1,62,42,20,67.2,40.7,26.5,0,0,0,0
591,f09a8b75,36,1899,21,21,3,15,0,0,25,30,-5,28.5,31.9,-3.5,0,0,0,0
592,f10983ae,10,863,9,10,8,0,14,0,6,16,-10,10.9,13.1,-2.1,0,0,0,0
593,f18d7ab2,4,275,3,4,1,0,8,1,1,4,-3,2.5,5.0,-2.6,0,0,0,0
594,f1b2365a,27,2334,25,26,23,1,1,1,27,27,0,30.3,30.4,0.0,0,0,0,0
595,f26dd9f8,0,0,0,0,0,0,1,0,0,0,0,0.0,0.0,0.0,0,0,0,0
596,f2c50778,0,0,0,0,0,0,2,0,0,0,0,0.0,0.0,0.0,0,0,0,0
597,f3085377,3,66,0,0,0,3,5,0,0,2,-2,0.6,2.3,-1.7,0,0,0,0
598,f323d995,34,3015,33,34,33,0,1,1,32,50,-18,38.2,50.0,-11.8,0,0,0,0
599,f329ec76,0,0,0,0,0,0,1,0,0,0,0,0.0,0.0,0.0,0,0,0,0
600,f340e64f,0,0,0,0,0,0,1,0,0,0,0,0.0,0.0,0.0,0,0,0,0
601,f3600c02,27,2260,25,26,20,1,0,2,41,19,22,35.4,26.8,8.6,0,0,0,0
602,f3642ba8,26,1073,11,10,5,16,8,0,11,21,-10,10.5,18.8,-8.3,0,0,0,0
603,f36c432f,8,399,4,4,1,4,0,0,4,2,2,8.7,3.1,5.6,0,0,0,0
604,f4319ee8,13,623,6,8,0,5,18,2,8,4,4,6.2,5.1,1.1,0,0,0,0
605,f449640d,36,3187,35,36,33,0,0,3,50,43,7,50.0,45.1,4.9,0,0,0,0
606,f4bc42b1,38,2476,27,27,11,11,0,1,48,40,8,36.5,38.1,-1.7,0,0,0,0
607,f5044e54,30,2394,26,26,24,4,0,1,20,24,-4,33.2,32.9,0.3,0,0,0,0
608,f54d2149,1,59,0,1,0,0,0,1,0,0,0,0.0,0.3,-0.3,0,0,0,0
609,f6db3bd5,14,1136,12,14,12,0,0,1,14,12,2,17.3,13.8,3.5,0,0,0,0
610,f7691f63,22,1291,14,15,9,7,13,1,18,17,1,17.0,16.6,0.4,0,0,0,0
611,f7b1d4e0,27,1827,20,20,9,7,0,1,19,27,-8,21.4,26.5,-5.1,0,0,0,0
612,f7d3a773,0,0,0,0,0,0,4,0,0,0,0,0.0,0.0,0.0,0,0,0,0
613,f81ef10d,0,0,0,0,0,0,1,0,0,0,0,0.0,0.0,0.0,0,0,0,0
614,f83c8d6c,35,2495,27,28,18,7,1,1,25,34,-9,29.2,41.1,-12.0,0,0,0,0
615,f84a807c,0,0,0,0,0,0,1,0,0,0,0,0.0,0.0,0.0,0,0,0,0
616,f86ca403,13,713,7,10,0,3,6,1,9,12,-3,11.3,9.7,1.5,0,0,0,0
617,f9921b7f,0,0,0,0,0,0,1,0,0,0,0,0.0,0.0,0.0,0,0,0,0
618,fa060e71,0,0,0,0,0,0,2,0,0,0,0,0.0,0.0,0.0,0,0,0,0
619,fa18c72e,25,781,8,6,1,19,11,1,12,11,1,12.0,11.0,1.0,0,0,0,0
620,fa27b5a0,0,0,0,0,0,0,7,0,0,0,0,0.0,0.0,0.0,0,0,0,0
621,faf873a7,0,0,0,0,0,0,4,0,0,0,0,0.0,0.0,0.0,0,0,0,0
622,fbbb9269,23,1908,21,21,17,2,4,1,20,22,-2,22.3,29.8,-7.5,0,0,0,0
623,fbf76716,4,177,2,1,1,3,2,0,0,2,-2,1.3,1.4,-0.1,0,0,0,0
624,fbf83734,0,0,0,0,0,0,38,0,0,0,0,0.0,0.0,0.0,0,0,0,0
625,fca455cc,6,116,1,0,0,6,18,1,1,4,-3,0.8,3.0,-2.3,0,0,0,0
626,fcb27134,0,0,0,0,0,0,1,0,0,0,0,0.0,0.0,0.0,0,0,0,0
627,fcb38f57,38,3420,38,38,38,0,0,1,68,33,35,59.5,42.1,17.4,0,0,0,0
628,fcbcbd94,27,1876,20,21,9,6,0,1,20,25,-5,23.0,25.5,-2.4,0,0,0,0
629,fd2bc67d,36,3226,35,36,35,0,0,1,30,31,-1,44.2,46.4,-2.2,0,0,0,0
630,fe006f82,1,90,1,1,1,0,5,0,0,1,-1,0.7,0.6,0.1,0,0,0,0
631,fe296c72,0,0,0,0,0,0,1,0,0,0,0,0.0,0.0,0.0,0,0,0,0
632,ff0ab48c,25,2044,22,21,17,4,5,1,43,30,13,49.8,27.1,22.6,0,0,0,0
633,ff20acfe,0,0,0,0,0,0,1,0,0,0,0,0.0,0.0,0.0,0,0,0,0
634,ff3a6a60,5,266,3,3,1,2,4,1,4,2,2,4.1,4.8,-0.7,0,0,0,0
635,ffa90327,0,0,0,0,0,0,2,0,0,0,0,0.0,0.0,0.0,0,0,0,0
