id,Tkl,TklW,Def 3rd,Mid 3rd,Att 3rd,Tkl.1,Att,Lost,Blocks,Sh,Pass,Int,Tkl+Int,Clr,Err
5f09991f,43,23,31,10,2,23,50,27,31,9,22,45,88,52,1
774cf58b,48,30,33,9,6,18,36,18,46,29,17,37,85,97,1
f586779e,8,4,2,5,1,3,14,11,20,2,18,6,14,27,0
f2bf1b0f,6,4,1,5,0,1,4,3,9,1,8,2,8,10,0
f76e6b4e,1,1,1,0,0,1,1,0,0,0,0,0,1,8,3
4d034881,7,4,0,4,3,1,8,7,9,1,8,3,10,2,0
2b1c4abd,1,0,0,0,1,0,0,0,0,0,0,0,1,0,0
eaeca114,31,21,23,8,0,14,23,9,40,29,11,36,67,152,0
b827d5b3,24,17,10,13,1,9,30,21,19,2,17,10,34,8,0
f7d50789,40,29,24,13,3,11,24,13,48,32,16,31,71,172,2
cd1acf9d,55,34,35,17,3,36,78,42,27,9,18,45,100,84,3
7a2e46a8,0,0,0,0,0,0,2,2,0,0,0,1,1,13,3
cea4ee8f,34,16,11,20,3,13,37,24,35,3,32,17,51,17,2
862a1c15,60,39,32,20,8,19,52,33,25,1,24,31,91,25,0
f4290206,28,16,20,6,2,14,33,19,18,2,16,20,48,32,0
ad1f61f3,33,19,20,11,2,17,27,10,18,3,15,14,47,13,0
9260926b,18,11,9,8,1,3,11,8,8,5,3,16,34,55,1
9f1893b9,46,32,20,21,5,11,47,36,19,1,18,22,68,11,0
dc008610,1,1,0,1,0,1,1,0,1,1,0,0,1,1,0
30941e96,5,2,3,1,1,5,7,2,1,0,1,9,14,15,0
b105919e,0,0,0,0,0,0,0,0,1,0,1,0,0,0,0
ac05f970,13,9,5,4,4,4,14,10,17,2,15,9,22,5,0
97333cf5,32,19,19,11,2,9,38,29,22,4,18,11,43,23,1
28d596a0,1,1,1,0,0,1,2,1,0,0,0,1,2,7,2
8816329f,10,8,5,5,0,5,14,9,19,0,19,5,15,9,0
d5dd5f1f,31,19,10,12,9,12,51,39,39,1,38,14,45,16,0
5c2b4f07,93,69,58,27,8,39,69,30,38,6,32,47,140,98,2
da052c14,48,30,10,22,16,17,49,32,29,4,25,15,63,21,0
53cad200,86,56,40,32,14,35,69,34,56,21,35,67,153,94,0
a1232f4e,0,0,0,0,0,0,1,1,3,3,0,4,4,7,1
b18095b6,10,6,6,2,2,8,10,2,5,2,3,5,15,14,0
3626f7d9,17,12,13,3,1,9,25,16,15,5,10,26,43,75,3
394854c4,62,43,35,17,10,27,47,20,26,3,23,34,96,83,3
1ae30132,49,36,16,24,9,24,37,13,24,11,13,30,79,73,0
3a24769f,16,9,6,6,4,5,18,13,7,2,5,7,23,7,0
2691c772,10,5,3,5,2,3,9,6,7,2,5,6,16,9,0
3ea50f67,16,11,7,7,2,5,23,18,13,3,10,8,24,6,1
1aa84968,85,48,58,20,7,48,81,33,38,15,23,77,162,173,1
8c44e37b,1,0,0,1,0,0,2,2,1,0,1,0,1,0,1
2973d8ff,4,1,2,2,0,0,5,5,1,1,0,0,4,1,0
4115ce4e,65,38,41,18,6,31,61,30,44,23,21,77,142,198,4
f874dd44,20,13,7,11,2,11,29,18,20,4,16,19,39,27,1
0bad4516,4,2,4,0,0,2,6,4,14,8,6,9,13,29,0
0bad4516,5,4,3,2,0,4,6,2,3,1,2,7,12,8,0
3189f61a,23,13,14,9,0,7,25,18,9,2,7,19,42,9,1
ab070c55,9,5,1,6,2,0,10,10,11,4,7,4,13,28,1
f72293fc,4,2,2,2,0,1,8,7,8,1,7,7,11,9,0
d0b6129f,22,15,3,14,5,5,10,5,15,1,14,10,32,16,0
a29b1131,10,6,3,6,1,4,12,8,12,0,12,1,11,5,0
ab4b3e35,32,22,12,14,6,13,44,31,22,2,20,16,48,7,0
17370b95,27,16,12,9,6,13,17,4,7,3,4,6,33,24,0
01226327,47,29,22,15,10,26,58,32,27,12,15,37,84,31,1
7ca9f0f0,8,6,4,4,0,2,5,3,4,0,4,1,9,6,0
d328a254,72,46,30,37,5,17,65,48,59,16,43,66,138,97,1
6c203af0,49,38,24,22,3,17,40,23,18,2,16,21,70,23,0
a4ac4b8f,57,33,36,21,0,25,43,18,28,11,17,39,96,108,3
cfd5e123,1,0,0,0,1,0,0,0,1,1,0,0,1,0,0
b0c71810,16,8,6,5,5,6,15,9,17,0,17,4,20,1,0
79c84d1c,19,15,7,9,3,4,17,13,6,0,6,16,35,8,0
96bb8cc2,11,9,5,4,2,3,10,7,10,2,8,5,16,8,0
c1949191,8,7,5,3,0,3,5,2,6,3,3,2,10,12,0
10072610,0,0,0,0,0,0,0,0,0,0,0,0,0,1,1
97220da2,0,0,0,0,0,0,0,0,0,0,0,0,0,0,0
dc4cae05,5,5,1,2,2,2,14,12,5,1,4,2,7,1,0
47369df8,14,8,5,7,2,5,13,8,9,4,5,14,28,18,0
66b76d44,82,39,57,21,4,38,118,80,58,5,53,23,105,32,2
b2d31e83,67,42,35,27,5,25,53,28,44,20,24,42,109,130,0
1bf811d4,40,22,24,11,5,18,37,19,16,8,8,26,66,73,0
a179d516,0,0,0,0,0,0,0,0,0,0,0,0,0,3,0
7914b9fe,15,8,11,4,0,7,15,8,34,25,9,18,33,114,1
59e6e5bf,7,5,1,4,2,1,10,9,15,2,13,6,13,36,0
b2d03887,0,0,0,0,0,0,0,0,0,0,0,0,0,0,0
bd6351cd,40,24,21,12,7,24,40,16,9,2,7,21,61,18,0
f63d8a4b,51,31,19,27,5,26,73,47,38,2,36,18,69,35,1
5acc4a10,75,40,38,30,7,37,85,48,30,11,19,68,143,61,0
b581987a,5,3,3,2,0,2,8,6,2,1,1,2,7,24,1
e28868f3,91,55,54,26,11,29,82,53,45,10,35,53,144,45,2
89e4b358,41,26,25,15,1,10,24,14,19,16,3,25,66,136,1
c0617e2b,45,23,26,14,5,18,61,43,14,3,11,32,77,16,1
422862ea,30,11,13,13,4,12,27,15,10,4,6,18,48,20,0
dc6f5bdd,26,10,12,8,6,11,16,5,13,7,6,16,42,43,1
d2424d1b,43,26,28,13,2,23,52,29,30,6,24,28,71,68,2
2696b6a9,0,0,0,0,0,0,0,0,0,0,0,0,0,0,0
7d2d3329,17,8,7,8,2,3,25,22,15,6,9,24,41,13,0
1cb49278,38,21,25,12,1,15,21,6,12,8,4,29,67,56,0
2b91cf8e,20,12,18,2,0,9,15,6,18,14,4,11,31,82,0
91c975a0,0,0,0,0,0,0,0,0,0,0,0,0,0,2,0
6cdd8245,28,15,8,14,6,9,36,27,13,1,12,10,38,15,0
2928dca2,36,23,30,6,0,15,30,15,22,15,7,28,64,119,2
0420d84f,42,31,24,14,4,19,25,6,21,9,12,24,66,43,1
27c01749,7,6,1,4,2,3,10,7,11,0,11,0,7,3,0
2afc7272,27,14,15,9,3,10,47,37,17,5,12,17,44,17,1
3e5e4e63,22,11,18,4,0,8,20,12,32,23,9,44,66,153,1
74e12f1e,35,24,10,20,5,12,62,50,34,12,22,28,63,49,0
4f974391,43,26,21,18,4,23,46,23,33,10,23,35,78,75,2
a4fe8cda,4,2,2,1,1,1,5,4,1,1,0,2,6,1,0
d9565625,3,2,3,0,0,3,4,1,1,0,1,2,5,1,0
9d107085,1,1,0,1,0,0,1,1,2,0,2,1,2,5,1
f08490a6,4,2,3,1,0,1,4,3,2,0,2,8,12,4,1
52105203,8,4,7,1,0,8,14,6,9,7,2,14,22,67,0
6e33125f,6,4,3,3,0,4,7,3,7,3,4,2,8,7,0
44781702,28,15,13,11,4,7,21,14,28,12,16,22,50,47,0
9228b07c,38,17,12,22,4,17,55,38,12,4,8,35,73,28,0
9deaf2c8,1,1,0,1,0,0,3,3,4,0,4,0,1,3,0
3e9e06cb,29,18,16,13,0,17,31,14,41,32,9,34,63,116,0
e46012d4,45,24,8,20,17,18,66,48,26,4,22,18,63,24,2
82e34b69,19,12,6,10,3,6,29,23,13,1,12,11,30,27,0
111c3236,26,12,10,13,3,9,22,13,12,3,9,15,41,19,1
5a7301ae,68,31,41,19,8,28,67,39,39,12,27,38,106,64,2
39583cfd,33,16,18,9,6,12,59,47,10,0,10,25,58,6,0
ac861941,21,12,10,10,1,10,20,10,14,9,5,21,42,65,0
1b84dbe1,73,49,49,19,5,33,68,35,39,10,29,42,115,108,0
a712ca2b,27,15,18,9,0,16,25,9,37,21,16,47,74,166,2
254147d4,27,21,13,9,5,11,21,10,15,1,14,9,36,9,0
d557d734,55,29,34,17,4,27,41,14,34,4,30,40,95,52,1
02b29014,64,30,29,29,6,16,57,41,46,8,38,31,95,32,0
5526deb1,0,0,0,0,0,0,1,1,0,0,0,0,0,0,0
2649ff32,5,3,3,2,0,2,18,16,5,0,5,5,10,5,1
2649ff32,2,1,1,1,0,0,1,1,0,0,0,1,3,0,0
15ea94de,3,2,1,2,0,0,8,8,6,0,6,1,4,5,1
3a949a25,1,1,1,0,0,1,2,1,2,0,2,1,2,17,5
79ca3e23,18,11,9,6,3,7,16,9,10,2,8,6,24,8,0
7314bba4,18,9,14,4,0,6,17,11,13,7,6,21,39,72,0
3fe6bd8c,27,17,19,7,1,21,27,6,23,9,14,23,50,69,0
282f75f3,40,24,23,17,0,15,34,19,55,33,22,55,95,125,2
3bb7b8b4,2,2,2,0,0,2,5,3,0,0,0,3,5,16,6
debe38a0,44,27,34,10,0,25,45,20,39,27,12,58,102,171,4
c8387671,0,0,0,0,0,0,0,0,0,0,0,0,0,0,0
615ef733,19,9,10,7,2,10,21,11,11,5,6,13,32,25,1
4fdf1fd9,11,6,8,2,1,8,13,5,18,17,1,28,39,86,3
980522ec,19,9,10,8,1,7,24,17,10,1,9,12,31,16,0
f8fcd2a5,48,34,33,14,1,28,39,11,33,18,15,57,105,174,4
9328b835,2,2,2,0,0,2,4,2,0,0,0,1,3,5,3
7f3b388c,62,35,20,35,7,26,67,41,25,2,23,34,96,19,1
1e43fad8,0,0,0,0,0,0,0,0,0,0,0,0,0,0,0
9d9a71c1,0,0,0,0,0,0,0,0,0,0,0,0,0,0,0
e5d01ecf,68,38,49,17,2,43,80,37,16,2,14,36,104,49,0
507c7bdf,22,12,9,9,4,5,38,33,6,0,6,11,33,16,0
e2dde94c,2,0,2,0,0,0,2,2,2,0,2,1,3,0,0
f25b010f,42,25,30,10,2,23,46,23,41,28,13,24,66,190,2
101da2b5,50,35,32,16,2,29,48,19,28,16,12,25,75,82,0
4c370d81,37,19,8,14,15,10,43,33,34,3,31,7,44,11,1
b63e789d,36,25,13,14,9,22,64,42,25,3,22,24,60,26,0
ed1e53f3,14,10,4,6,4,6,19,13,5,0,5,6,20,2,0
82927de4,46,28,21,18,7,19,64,45,35,1,34,25,71,15,0
d0b3ceb9,1,0,1,0,0,1,3,2,1,0,1,0,1,16,2
a9142dc3,1,1,0,1,0,1,4,3,0,0,0,4,5,1,0
45e17712,1,0,1,0,0,0,0,0,1,0,1,2,3,2,0
6c7762c3,7,3,5,2,0,3,4,1,1,0,1,1,8,3,1
1e0b6a73,13,9,11,2,0,11,21,10,17,12,5,20,33,71,0
d56543a0,12,6,5,5,2,7,22,15,15,3,12,15,27,24,0
b853e0ad,60,32,33,22,5,25,100,75,44,8,36,38,98,32,0
c067631c,82,56,59,18,5,41,64,23,20,10,10,24,106,73,1
c13c24c8,0,0,0,0,0,0,0,0,0,0,0,0,0,0,0
636b64cd,6,4,2,2,2,2,8,6,1,0,1,10,16,6,0
a67a09fb,14,9,8,6,0,8,19,11,8,3,5,17,31,33,1
2bed3eab,6,1,4,2,0,5,9,4,2,0,2,18,24,33,0
4e015693,0,0,0,0,0,0,1,1,0,0,0,0,0,1,0
e58a03c6,12,10,4,6,2,4,8,4,5,0,5,2,14,9,0
63d17038,0,0,0,0,0,0,0,0,0,0,0,1,1,4,1
6bd603db,4,3,1,1,2,1,2,1,1,0,1,1,5,4,0
7ba6d84e,0,0,0,0,0,0,0,0,0,0,0,0,0,7,4
ffa90327,20,11,12,5,3,8,26,18,10,1,9,13,33,16,1
32f60ed8,0,0,0,0,0,0,0,0,0,0,0,2,2,0,0
df10e27c,5,2,3,2,0,2,4,2,2,0,2,3,8,3,1
16ceb862,8,3,2,5,1,1,11,10,14,1,13,2,10,13,0
9f7c837d,22,14,18,3,1,10,18,8,41,37,4,25,47,152,3
1961b2aa,22,15,7,11,4,8,62,54,20,3,17,7,29,7,0
645a3363,0,0,0,0,0,0,0,0,1,0,1,0,0,0,0
7a11550b,23,16,17,6,0,9,20,11,15,8,7,38,61,64,2
2bd83368,11,7,5,6,0,5,15,10,6,2,4,8,19,4,0
7fec31a0,26,10,14,9,3,6,27,21,31,11,20,20,46,26,0
c24dba2a,4,3,0,2,2,1,3,2,4,1,3,1,5,2,0
4468ec10,12,6,6,6,0,6,12,6,7,0,7,5,17,4,0
b0b4fd3e,29,19,12,12,5,13,34,21,33,12,21,22,51,22,1
58eee997,17,11,5,6,6,5,20,15,9,0,9,6,23,6,1
8aec0537,36,13,8,21,7,14,39,25,25,3,22,9,45,7,0
ab13a5aa,1,1,1,0,0,1,2,1,0,0,0,0,1,18,3
5ea8ef20,31,16,14,13,4,14,43,29,21,7,14,29,60,38,2
5d8d7454,74,43,48,20,6,36,67,31,33,10,23,49,123,74,2
819b3158,27,16,9,11,7,9,41,32,17,5,12,31,58,13,0
e082af5b,1,1,1,0,0,1,3,2,0,0,0,0,1,1,0
ba115a40,22,15,8,10,4,3,30,27,19,5,14,8,30,27,0
e9254eec,24,15,17,7,0,8,14,6,25,18,7,31,55,77,1
bf8fad51,21,9,15,5,1,8,15,7,27,19,8,20,41,98,4
c951a6df,55,27,33,17,5,20,50,30,24,7,17,38,93,38,0
a6de6361,3,2,3,0,0,3,4,1,0,0,0,0,3,6,0
e5a76dfe,0,0,0,0,0,0,0,0,0,0,0,1,1,13,1
935e6b8f,63,41,18,33,12,22,55,33,22,4,18,30,93,21,2
989d5705,18,10,7,8,3,7,27,20,21,8,13,20,38,20,0
76eca7e2,0,0,0,0,0,0,0,0,0,0,0,1,1,3,1
189cee7b,0,0,0,0,0,0,1,1,0,0,0,1,1,0,0
007b39a5,27,19,13,11,3,9,31,22,12,1,11,19,46,10,0
92e7e919,23,15,10,11,2,9,57,48,23,0,23,19,42,18,1
78e87179,0,0,0,0,0,0,0,0,0,0,0,0,0,0,0
d79a8c87,4,2,3,1,0,1,3,2,10,6,4,5,9,45,1
12aa7661,26,15,19,7,0,9,28,19,11,4,7,3,29,33,0
d0042ab9,44,26,30,13,1,21,31,10,26,13,13,34,78,97,0
45ab2170,3,1,2,1,0,0,0,0,1,0,1,0,3,0,0
fcab00a0,16,10,4,8,4,10,25,15,19,4,15,9,25,31,0
15f3ec41,10,4,4,5,1,1,7,6,9,0,9,5,15,4,1
a0666d3e,75,47,24,41,10,25,67,42,48,8,40,37,112,28,0
8b04d6c1,80,49,34,38,8,39,91,52,44,5,39,46,126,54,2
9f736ed2,2,2,2,0,0,1,1,0,0,0,0,0,2,1,0
291e3ec3,2,2,1,0,1,2,3,1,4,0,4,0,2,1,0
03622183,2,2,0,2,0,1,3,2,1,1,0,0,2,0,0
c92e1a31,3,1,1,2,0,1,9,8,8,1,7,3,6,8,0
07802f7f,42,25,16,16,10,13,67,54,62,4,58,9,51,30,1
6ca5ec4b,25,17,8,15,2,12,33,21,18,2,16,14,39,10,1
3233eefd,5,4,3,2,0,1,3,2,5,5,0,4,9,19,0
08452314,8,4,3,2,3,0,2,2,5,0,5,3,11,2,0
c931d9f9,20,10,5,10,5,7,45,38,23,4,19,7,27,12,0
ebd0a048,0,0,0,0,0,0,0,0,0,0,0,0,0,0,0
1265a93a,36,23,18,14,4,11,29,18,19,8,11,22,58,28,0
45da6694,14,10,8,6,0,6,13,7,7,2,5,7,21,23,0
b66315ae,17,10,4,5,8,7,25,18,26,1,25,11,28,6,0
b561db50,20,12,6,10,4,3,31,28,26,0,26,16,36,34,1
e8832875,0,0,0,0,0,0,0,0,0,0,0,0,0,0,0
c17bfb65,34,20,7,22,5,9,32,23,32,6,26,11,45,30,0
9319781b,8,4,7,1,0,7,10,3,5,2,3,3,11,11,0
4fb9c88f,4,4,0,1,3,3,4,1,2,0,2,2,6,1,0
def899bd,2,2,1,1,0,1,1,0,2,0,2,2,4,9,1
41ff002d,0,0,0,0,0,0,0,0,1,0,1,0,0,0,0
45db685d,66,40,24,34,8,35,91,56,30,5,25,64,130,27,2
9f351459,3,1,2,0,1,2,5,3,1,0,1,3,6,6,0
178ae8f8,28,15,16,10,2,12,48,36,17,0,17,9,37,10,2
fb614c44,36,17,22,14,0,15,25,10,15,7,8,11,47,30,0
914ab9a1,37,24,26,11,0,17,32,15,31,23,8,36,73,127,0
21a66f6a,18,12,3,12,3,4,17,13,17,7,10,6,24,30,0
b9fbae28,44,20,22,14,8,17,36,19,29,5,24,44,88,32,2
3d50bcdb,6,6,5,1,0,0,0,0,4,0,4,5,11,1,1
c5b7c315,31,16,18,12,1,14,24,10,35,28,7,44,75,152,0
f25c8e3a,30,14,8,16,6,11,26,15,18,0,18,10,40,4,0
f31def1e,7,3,3,4,0,6,7,1,9,5,4,6,13,15,1
d7492450,23,18,19,4,0,14,31,17,18,10,8,16,39,86,1
d0f72bf1,4,2,1,3,0,2,2,0,1,1,0,4,8,7,0
43458538,16,6,4,8,4,4,16,12,20,3,17,8,24,9,0
5f1d07f6,8,2,5,2,1,7,11,4,6,6,0,7,15,29,0
ecf44e09,0,0,0,0,0,0,1,1,0,0,0,0,0,1,0
3935e52e,29,16,18,6,5,12,23,11,14,4,10,25,54,34,1
0313a347,18,9,12,6,0,7,16,9,34,24,10,25,43,70,2
8d3c902d,67,32,43,20,4,26,48,22,35,11,24,43,110,58,1
79c0821a,63,38,29,32,2,26,65,39,15,1,14,22,85,16,1
77cf6852,18,12,15,2,1,9,20,11,11,8,3,8,26,45,0
f23f9d20,0,0,0,0,0,0,1,1,2,0,2,1,1,13,1
9dbb75ca,31,16,8,21,2,9,24,15,14,0,14,7,38,15,0
99813635,19,9,7,9,3,6,21,15,7,0,7,5,24,3,0
abe66106,24,20,9,13,2,2,21,19,12,3,9,8,32,10,0
f4e433d4,2,2,1,1,0,2,2,0,0,0,0,0,2,0,0
f4e433d4,7,6,6,1,0,2,9,7,6,0,6,16,23,17,0
fe8e6fa1,6,2,3,1,2,2,8,6,4,0,4,0,6,3,0
26f6dca8,14,9,6,6,2,7,39,32,9,1,8,10,24,3,0
119b9a8e,13,6,6,7,0,4,9,5,6,5,1,20,33,26,1
450ab6fc,14,3,10,4,0,4,9,5,23,20,3,28,42,116,1
016ff750,13,9,11,2,0,11,18,7,2,0,2,3,16,4,0
9460aaed,16,9,8,7,1,9,25,16,14,4,10,9,25,10,1
6eaed4eb,8,2,6,2,0,4,7,3,6,2,4,10,18,15,2
2ff964a0,14,8,7,4,3,7,10,3,6,1,5,8,22,3,0
2628fd2b,0,0,0,0,0,0,2,2,0,0,0,0,0,9,2
9b5ce51a,54,32,17,31,6,22,48,26,28,12,16,57,111,54,1
efb9215a,51,35,42,6,3,22,36,14,27,12,15,25,76,68,0
f5deef4c,29,15,16,12,1,17,20,3,25,16,9,26,55,129,0
810e3c74,15,8,6,4,5,5,18,13,5,0,5,3,18,0,0
8f62b6ee,0,0,0,0,0,0,0,0,0,0,0,1,1,3,2
d7553721,51,29,12,33,6,12,59,47,20,4,16,9,60,19,0
6cc47ae1,0,0,0,0,0,0,0,0,0,0,0,0,0,0,0
e97fd090,0,0,0,0,0,0,2,2,1,1,0,2,2,2,0
5a4280b1,7,5,6,1,0,4,9,5,9,7,2,4,11,31,0
9f472354,19,10,5,8,6,7,19,12,12,0,12,4,23,16,0
c0027d2d,3,1,2,1,0,3,14,11,4,1,3,5,8,3,0
a2b105e0,35,19,17,16,2,20,50,30,23,5,18,19,54,20,2
1a2935f6,13,8,10,3,0,7,12,5,9,6,3,10,23,42,0
9a9c05db,41,22,20,18,3,22,33,11,20,6,14,27,68,57,1
c0e27d1a,28,16,14,14,0,13,24,11,42,37,5,32,60,133,2
6f7d826d,46,24,25,17,4,19,65,46,42,15,27,36,82,54,1
0df2b165,46,30,18,21,7,21,65,44,18,4,14,33,79,46,1
83d074ff,9,5,4,3,2,5,9,4,12,0,12,1,10,2,0
ee38d9c5,59,30,13,31,15,23,68,45,16,0,16,9,68,7,1
d8931174,37,23,23,14,0,18,34,16,31,22,9,72,109,159,0
892d5bb1,28,14,11,9,8,11,38,27,31,1,30,18,46,8,2
e3a5814e,41,23,34,5,2,22,43,21,12,3,9,28,69,38,0
c691bfe2,44,32,9,20,15,13,40,27,19,0,19,13,57,11,2
758dd7f0,39,26,27,8,4,24,38,14,14,2,12,18,57,56,0
bb5fbd2b,25,12,16,6,3,9,19,10,16,4,12,20,45,14,2
aa54ec6f,2,1,2,0,0,0,0,0,0,0,0,1,3,10,0
8aa5f52c,20,14,15,4,1,11,30,19,22,7,15,11,31,73,0
8b788c01,15,12,1,4,10,1,16,15,18,1,17,5,20,17,0
07666c20,0,0,0,0,0,0,0,0,0,0,0,0,0,1,1
3f072a68,1,0,0,0,1,0,0,0,1,0,1,1,2,0,0
48a5a5d6,20,15,10,6,4,7,20,13,15,1,14,3,23,8,0
7956236f,0,0,0,0,0,0,0,0,0,0,0,0,0,1,0
de0f152c,38,22,24,11,3,14,37,23,26,12,14,28,66,66,0
57df7a11,41,23,24,13,4,23,39,16,19,5,14,14,55,23,0
29733c72,7,3,1,5,1,2,7,5,5,1,4,0,7,2,0
eb7822d7,46,24,23,19,4,20,43,23,21,8,13,22,68,28,1
b217ef29,13,9,4,7,2,4,11,7,8,4,4,12,25,38,0
4bcf39f6,20,12,1,13,6,9,29,20,24,0,24,4,24,10,0
cee31595,88,51,43,34,11,37,106,69,69,19,50,60,148,56,0
78b8ac63,37,22,6,27,4,11,40,29,25,3,22,15,52,43,0
36c2ca73,1,1,1,0,0,1,1,0,1,0,1,0,1,11,3
64b08de7,82,47,36,36,10,40,76,36,24,5,19,24,106,11,0
90f91999,53,35,19,23,11,18,62,44,25,1,24,25,78,18,0
dbe56a33,41,26,9,24,8,5,20,15,14,2,12,3,44,23,0
51a19d04,0,0,0,0,0,0,0,0,0,0,0,0,0,1,1
471f16b3,44,29,20,18,6,14,42,28,32,7,25,38,82,67,2
fc15fb84,47,33,18,22,7,23,71,48,60,8,52,30,77,34,0
d93c2511,43,22,14,25,4,17,32,15,25,5,20,31,74,34,2
8df7a2fb,41,22,25,16,0,17,29,12,42,31,11,42,83,165,2
5271c8f1,18,15,7,7,4,9,27,18,10,2,8,16,34,21,3
1598599e,7,5,4,1,2,4,5,1,4,1,3,6,13,6,0
fed96827,20,9,13,7,0,11,14,3,17,11,6,17,37,62,1
eba42d2b,19,11,10,9,0,8,18,10,6,1,5,7,26,4,0
2ce2508a,61,32,32,25,4,35,84,49,30,7,23,42,103,39,4
2f90f6b8,16,10,3,10,3,6,26,20,12,3,9,7,23,17,1
6d5701f2,39,22,25,12,2,18,24,6,20,14,6,28,67,102,1
f833a830,3,3,0,2,1,2,10,8,3,0,3,0,3,3,0
8397a50c,15,11,11,3,1,10,13,3,56,48,8,30,45,190,4
5cbd1eb0,5,2,2,2,1,1,7,6,2,0,2,2,7,3,0
dd0daf32,0,0,0,0,0,0,2,2,3,0,3,0,0,1,0
d4cb83cc,1,1,1,0,0,1,3,2,3,1,2,3,4,10,0
5cec2487,57,29,31,20,6,30,56,26,19,5,14,24,81,40,0
e7434f04,1,0,1,0,0,1,1,0,0,0,0,0,1,0,1
47b7e3af,37,24,9,18,10,6,40,34,36,7,29,23,60,32,1
bfae110f,15,8,3,8,4,0,5,5,10,2,8,4,19,23,0
80c31c97,4,1,3,1,0,0,3,3,5,3,2,7,11,19,0
bf59c794,0,0,0,0,0,0,0,0,0,0,0,0,0,0,0
9674002f,37,17,8,19,10,9,42,33,25,3,22,16,53,18,0
2b622f01,57,33,25,22,10,16,58,42,29,2,27,15,72,27,0
d9cfca3d,9,5,0,5,4,3,7,4,3,0,3,4,13,2,0
f5a00fa4,93,50,43,41,9,46,139,93,43,13,30,50,143,18,1
f2f29dda,5,2,0,3,2,2,9,7,6,2,4,1,6,12,0
3f2d59fe,17,10,11,5,1,6,12,6,10,6,4,18,35,72,0
5343eb4e,3,2,1,2,0,1,2,1,0,0,0,0,3,0,0
76c131da,0,0,0,0,0,0,1,1,0,0,0,0,0,0,0
de5b5570,55,28,28,20,7,24,67,43,50,11,39,39,94,38,3
6b47c5db,128,67,56,61,11,45,91,46,52,6,46,80,208,69,3
5cdddffa,24,16,10,13,1,9,22,13,20,3,17,14,38,7,0
c5bdb6e3,11,8,5,4,2,7,17,10,13,2,11,3,14,3,0
7ba2eaa9,9,4,3,6,0,4,15,11,2,0,2,6,15,4,0
44bfb6c5,62,33,27,32,3,34,86,52,38,9,29,56,118,34,1
3631ad41,15,7,10,5,0,9,21,12,6,1,5,7,22,16,0
af721f98,4,0,0,2,2,0,0,0,0,0,0,1,5,0,0
a53649b7,7,5,3,4,0,2,6,4,9,0,9,2,9,5,0
ff527768,52,30,19,28,5,22,64,42,20,6,14,20,72,10,1
43439614,66,37,35,24,7,28,97,69,34,12,22,47,113,40,1
bdedffac,0,0,0,0,0,0,0,0,0,0,0,0,0,1,1
312626c1,23,14,15,6,2,10,20,10,38,17,21,42,65,154,1
caa1a7f0,7,3,1,3,3,2,14,12,3,0,3,6,13,0,0
74b2cd7e,38,24,20,14,4,18,32,14,50,32,18,27,65,134,1
43a166b4,12,9,2,5,5,4,9,5,2,0,2,4,16,5,0
79bc4c45,15,10,11,3,1,3,16,13,6,1,5,6,21,7,0
0d267745,28,14,21,6,1,16,33,17,15,9,6,21,49,76,2
38c7feef,18,9,4,6,8,5,21,16,26,1,25,22,40,10,0
16380240,17,8,9,7,1,4,23,19,4,0,4,5,22,1,0
e0bc6fdc,23,12,8,11,4,10,15,5,13,1,12,18,41,19,0
b682dcf6,25,16,17,7,1,10,21,11,30,24,6,17,42,68,1
4357f557,0,0,0,0,0,0,0,0,0,0,0,0,0,0,0
79b0d6a0,0,0,0,0,0,0,2,2,2,0,2,2,2,5,2
3ca7254a,15,7,5,9,1,3,15,12,9,0,9,9,24,1,0
57e3f0c7,32,17,15,13,4,8,16,8,15,2,13,8,40,5,0
6639e500,24,13,8,9,7,10,39,29,13,0,13,7,31,7,0
75a72a99,119,68,65,36,18,53,106,53,38,6,32,49,168,86,0
75f2c59f,20,8,11,7,2,9,28,19,21,0,21,14,34,12,1
819aa8e7,45,28,14,26,5,8,54,46,33,1,32,14,59,9,1
4806ec67,0,0,0,0,0,0,4,4,0,0,0,3,3,12,6
9a526299,0,0,0,0,0,0,0,0,0,0,0,0,0,1,0
1ef37668,54,32,18,29,7,28,69,41,30,4,26,28,82,60,1
7fcc71d8,3,3,2,0,1,0,2,2,4,1,3,2,5,1,0
867239d3,20,9,8,8,4,8,16,8,12,4,8,7,27,10,2
4b40d9ca,1,1,1,0,0,1,2,1,0,0,0,3,4,15,3
86695068,33,18,8,21,4,9,29,20,19,1,18,17,50,12,0
f5e6d08d,0,0,0,0,0,0,0,0,0,0,0,0,0,4,0
fdd85f94,64,35,28,28,8,23,74,51,27,8,19,38,102,36,4
0745b37d,12,6,3,5,4,1,23,22,13,0,13,6,18,7,0
1bf33a9a,23,11,13,4,6,7,24,17,15,0,15,6,29,11,0
62437b4f,7,4,4,2,1,3,8,5,2,1,1,3,10,4,0
41fb0f4e,2,0,1,1,0,1,2,1,3,0,3,0,2,0,0
466fb2c5,4,3,4,0,0,3,3,0,0,0,0,0,4,25,1
6385ebfb,0,0,0,0,0,0,0,0,0,0,0,0,0,2,0
a1d5bd30,13,9,1,6,6,9,23,14,23,0,23,10,23,19,0
ab651565,49,29,17,23,9,21,57,36,39,2,37,16,65,16,0
e358587b,0,0,0,0,0,0,2,2,0,0,0,0,0,9,1
1c7012b8,116,60,64,48,4,47,98,51,41,9,32,77,193,55,0
fa031b34,70,47,28,28,14,27,56,29,34,4,30,12,82,42,0
d9ba39fc,61,39,32,24,5,29,59,30,31,7,24,84,145,91,0
7a1f2c08,14,10,4,10,0,7,11,4,7,2,5,17,31,23,1
71ef519e,22,15,9,10,3,3,15,12,20,5,15,14,36,31,1
ba3ca78f,0,0,0,0,0,0,0,0,0,0,0,0,0,2,2
59d93937,0,0,0,0,0,0,0,0,0,0,0,0,0,0,0
2e4f5f03,54,31,17,25,12,27,61,34,29,7,22,38,92,72,1
e75750a3,6,3,2,2,2,2,7,5,3,0,3,7,13,3,0
7399c7a8,10,5,5,5,0,1,6,5,12,5,7,8,18,24,0
6434f10d,50,30,17,25,8,23,63,40,19,5,14,26,76,35,0
4ab53cdb,29,19,4,13,12,8,33,25,33,6,27,5,34,12,0
a07579ee,0,0,0,0,0,0,0,0,0,0,0,0,0,1,0
e0991c04,3,1,2,1,0,1,2,1,2,1,1,0,3,6,0
4b511457,55,35,23,30,2,27,75,48,35,13,22,34,89,32,0
89d10e53,18,11,6,10,2,9,20,11,14,6,8,8,26,34,2
89d10e53,21,12,11,8,2,12,21,9,11,4,7,10,31,14,1
18b896d6,28,18,19,7,2,16,25,9,15,9,6,16,44,59,1
3faa1780,15,9,7,5,3,5,17,12,11,0,11,15,30,4,0
4535e4bb,1,1,1,0,0,1,4,3,0,0,0,2,3,13,2
2b16cb1a,13,8,7,4,2,4,18,14,5,2,3,9,22,6,0
9fbbcf39,55,38,37,15,3,32,46,14,31,16,15,55,110,127,3
bc7dc64d,36,21,21,8,7,19,37,18,12,3,9,12,48,19,0
87935cf3,7,5,5,1,1,2,5,3,12,5,7,20,27,46,2
e342ad68,16,6,1,4,11,5,22,17,3,1,2,8,24,2,1
dae8623e,6,4,0,3,3,1,8,7,7,0,7,1,7,6,0
50b51fac,1,0,0,1,0,1,1,0,1,0,1,2,3,1,0
da7b447d,44,27,32,12,0,22,44,22,40,28,12,34,78,128,5
2b114be3,0,0,0,0,0,0,0,0,0,0,0,0,0,0,0
bfdb33aa,11,10,5,2,4,5,23,18,9,1,8,18,29,10,0
c8aa95da,39,21,25,14,0,19,40,21,35,18,17,47,86,74,2
a6e316c1,4,3,1,2,1,2,8,6,3,0,3,7,11,14,0
3312f911,18,9,10,7,1,6,16,10,11,3,8,13,31,15,0
53af52f3,1,1,1,0,0,1,2,1,0,0,0,1,2,4,2
51b41c5c,31,22,13,16,2,8,24,16,13,3,10,21,52,20,1
6aa3e78b,6,4,2,4,0,3,6,3,0,0,0,3,9,12,0
6421ec64,1,0,0,1,0,0,1,1,0,0,0,0,1,0,0
e8c9f4e9,6,5,2,1,3,1,6,5,2,0,2,1,7,2,0
9c94165b,34,18,19,11,4,19,33,14,26,6,20,24,58,56,1
3727dd3c,29,19,17,12,0,11,42,31,14,5,9,23,52,38,0
4c5b714f,83,44,48,25,10,43,72,29,19,3,16,40,123,41,0
76dd1480,50,26,15,24,11,19,70,51,30,4,26,37,87,17,1
3eb22ec9,36,18,8,21,7,13,44,31,25,1,24,24,60,13,0
e2716bd0,26,14,3,15,8,10,28,18,18,3,15,13,39,5,0
76fa5f80,5,2,4,1,0,2,8,6,1,0,1,2,7,12,1
2acd49b9,39,25,25,12,2,20,48,28,19,4,15,27,66,43,2
6250083a,2,2,0,2,0,1,4,3,3,2,1,0,2,0,0
5e105217,10,5,2,8,0,5,10,5,7,1,6,1,11,2,0
20b104bc,47,32,29,16,2,23,50,27,27,6,21,25,72,64,1
17695062,1,1,1,0,0,1,3,2,0,0,0,1,2,2,0
9f4647e9,29,16,17,10,2,13,44,31,12,1,11,4,33,11,0
839c14e1,8,6,2,6,0,1,3,2,3,0,3,3,11,4,0
839c14e1,45,26,19,24,2,25,41,16,18,4,14,19,64,51,0
e77dc3b2,8,4,2,5,1,5,33,28,9,1,8,8,16,18,1
6613c819,29,15,13,15,1,10,23,13,7,1,6,22,51,35,0
21166ff4,60,40,41,18,1,27,46,19,35,19,16,43,103,156,1
1fdec858,5,5,3,2,0,1,3,2,1,0,1,0,5,1,0
558807c0,21,11,9,11,1,8,22,14,27,11,16,18,39,64,1
6992791d,10,7,2,3,5,3,8,5,6,0,6,4,14,6,0
a8a3d139,0,0,0,0,0,0,0,0,0,0,0,0,0,0,0
653ee42d,73,44,30,37,6,25,75,50,31,11,20,58,131,42,2
6adbc307,44,27,30,13,1,24,46,22,38,22,16,31,75,120,2
b400bde0,27,15,8,10,9,6,28,22,16,2,14,15,42,4,0
17d4507a,81,46,48,26,7,42,96,54,27,8,19,35,116,71,3
b606638c,20,8,8,9,3,5,21,16,11,3,8,5,25,16,0
5eecec3d,16,10,8,7,1,3,5,2,5,3,2,9,25,32,2
f573a8bf,0,0,0,0,0,0,0,0,0,0,0,1,1,0,0
1d8c99b0,1,1,0,1,0,1,3,2,1,0,1,3,4,2,0
7d41b619,4,2,2,2,0,1,3,2,1,0,1,1,5,5,1
b017b770,0,0,0,0,0,0,0,0,1,0,1,1,1,0,0
e9971f2d,17,9,10,6,1,10,17,7,7,6,1,11,28,31,2
e514ab62,52,29,37,11,4,22,53,31,28,8,20,56,108,82,0
15ea812b,66,43,47,19,0,31,54,23,63,47,16,63,129,204,4
cc2d7ad5,39,24,26,9,4,19,39,20,29,9,20,29,68,78,1
c2f9d19f,16,11,12,4,0,11,20,9,15,5,10,20,36,43,0
f1e94cd6,0,0,0,0,0,0,0,0,0,0,0,0,0,0,0
75566759,23,18,7,16,0,11,39,28,20,9,11,43,66,72,1
b547f08c,0,0,0,0,0,0,0,0,0,0,0,0,0,0,0
fc027d02,1,0,0,1,0,0,3,3,2,0,2,3,4,7,0
fa38722f,0,0,0,0,0,0,0,0,0,0,0,0,0,0,0
56f7a928,52,29,17,30,5,24,74,50,43,4,39,22,74,18,0
fce2302c,20,16,13,6,1,11,15,4,10,4,6,9,29,37,1
e7ca0439,29,17,21,8,0,18,25,7,17,15,2,21,50,103,0
7edfbb8a,29,16,21,8,0,10,15,5,13,7,6,22,51,48,2
52611641,31,16,11,15,5,16,39,23,24,8,16,34,65,24,0
9a104dee,2,2,2,0,0,0,2,2,0,0,0,0,2,1,0
9a104dee,2,0,0,0,2,0,1,1,1,0,1,0,2,1,0
b28bbd58,34,21,12,17,5,15,37,22,18,0,18,15,49,10,1
9a28eba4,33,21,6,14,13,8,23,15,19,3,16,13,46,14,2
fe558029,0,0,0,0,0,0,0,0,0,0,0,0,0,1,1
3ae14ed1,38,16,18,15,5,9,44,35,23,2,21,25,63,18,0
38ceb24a,22,17,7,12,3,6,38,32,16,1,15,9,31,8,0
552aa16c,39,25,15,18,6,16,60,44,20,5,15,16,55,35,0
2baec6ce,2,2,0,2,0,1,2,1,1,0,1,5,7,5,1
531a4aa8,20,7,9,7,4,11,19,8,9,1,8,13,33,32,2
c2111b45,1,1,1,0,0,1,2,1,4,3,1,2,3,8,1
e06683ca,23,12,18,5,0,6,13,7,20,15,5,40,63,166,2
45963054,15,12,0,9,6,2,4,2,22,4,18,2,17,22,0
04e195ee,0,0,0,0,0,0,0,0,0,0,0,0,0,0,0
ba23a904,40,24,25,14,1,20,31,11,18,10,8,33,73,68,0
1900032e,19,12,14,5,0,11,28,17,15,9,6,26,45,99,2
b937e490,23,13,15,6,2,12,15,3,7,2,5,11,34,22,0
d484c261,2,2,0,0,2,1,1,0,0,0,0,0,2,1,0
16fa6881,27,16,14,11,2,16,27,11,9,0,9,10,37,4,2
0d4ceb32,4,3,0,3,1,3,6,3,7,3,4,1,5,6,0
1ecb65be,13,8,6,5,2,3,15,12,13,0,13,8,21,1,0
86dd77d1,28,18,12,15,1,12,29,17,15,6,9,28,56,42,1
984a5a64,13,8,5,6,2,6,16,10,10,3,7,14,27,21,1
984a5a64,8,5,8,0,0,5,9,4,4,2,2,3,11,5,1
9e525177,129,80,71,50,8,64,86,22,46,13,33,66,195,83,0
e0900238,0,0,0,0,0,0,0,0,0,0,0,0,0,0,0
8a7ff278,69,42,48,16,5,39,56,17,13,6,7,48,117,93,1
3515d404,92,48,39,39,14,39,94,55,48,14,34,60,152,75,1
603e4f0b,1,0,1,0,0,1,1,0,0,0,0,0,1,0,0
c40b6180,30,17,21,8,1,14,32,18,43,26,17,45,75,110,2
ce5143da,14,6,6,5,3,3,11,8,12,1,11,5,19,7,0
495945ef,54,33,15,32,7,17,48,31,23,11,12,32,86,32,3
41cc19c2,1,1,1,0,0,0,0,0,1,0,1,1,2,0,0
eb58eef0,38,20,12,21,5,10,40,30,18,4,14,17,55,34,3
9050ddc4,37,19,29,6,2,18,39,21,20,5,15,17,54,42,1
5e74d6c8,21,15,11,6,4,9,29,20,9,4,5,16,37,27,0
dd323728,5,3,1,3,1,4,5,1,3,1,2,9,14,6,0
8b9ebd03,45,27,14,24,7,14,43,29,15,0,15,20,65,7,0
a3b03921,25,16,9,12,4,8,21,13,16,2,14,4,29,11,2
9c318325,1,0,1,0,0,0,4,4,3,0,3,1,2,0,0
c596fcb0,12,9,3,6,3,2,17,15,16,2,14,4,16,16,0
c6dc9ecd,23,13,8,10,5,11,34,23,26,2,24,11,34,15,1
2f7acede,40,24,18,20,2,17,54,37,27,8,19,36,76,32,1
4e9a0555,7,4,2,4,1,5,15,10,15,2,13,4,11,18,0
e61b8aee,45,25,20,19,6,25,55,30,32,16,16,21,66,59,3
849c826a,13,8,5,6,2,5,20,15,3,1,2,6,19,4,0
ae0a7ddf,18,13,10,6,2,8,16,8,13,7,6,10,28,20,0
caffaf5a,8,5,4,1,3,3,7,4,6,2,4,4,12,27,1
be927d03,14,7,7,4,3,5,17,12,8,2,6,11,25,29,0
6813ac34,18,10,12,5,1,6,13,7,5,3,2,14,32,21,0
b2bc3b1f,43,19,18,12,13,12,49,37,22,2,20,18,61,4,0
2d5f03bf,32,21,26,6,0,21,30,9,22,18,4,19,51,87,2
51cf8561,31,19,16,11,4,17,32,15,9,0,9,17,48,21,1
d2d74d9c,2,2,0,2,0,1,2,1,1,0,1,0,2,0,0
ce4246f5,23,14,17,6,0,9,16,7,22,14,8,58,81,116,2
